一部	itibu	one part
一般	ippan	general
一時	itizi	one o'clock
一番	itiban	best
一緒	issyo	together
一致	itti	coincidence
一定	ittei	fixed
一連	itiren	series
一言	hitokoto	single word
一塁	itirui	first base
一環	ikkan	link
一体	ittai	...the heck
一斉	issei	simultaneous
一家	ikka	a house
一切	issai	all
一貫	ikkan	consistency
一瞬	issyun	moment
一品	ippin	item
一律	itiritu	evenness
一転	itten	turn
一種	issyu	species
一生	issyoo	whole life
一括	ikkatu	all together
一手	itte	move
一角	ikkaku	corner
一員	itiin	person
一層	issoo	much more
一因	itiin	cause
一変	ippen	complete change
一覧	itiran	look
一夜	itiya	one night
一流	itiryuu	first-class
一挙	ikkyo	one effort
一線	issen	line
一族	itizoku	family
一掃	issoo	clean sweep
一帯	ittai	region
一新	issin	complete change
一周	issyuu	once around
一丸	itigan	lump
一端	ittan	one end
一段	itidan	more
一行	ikkoo	line
一国	ikkoku	whole country
一場	itizyoo	one time
一門	itimon	family
一打	itida	stroke
一刻	ikkoku	minute
一堂	itidoo	one building
一目	itimoku	look
一任	itinin	entrusting
一途	itto	way
一大	itidai	one large ...
一室	issitu	one room
一節	issetu	a verse
一報	ippoo	information
一元	itigen	unitary
一様	itiyoo	uniformity
一幕	hitomaku	one act
一心	issin	one mind
一服	ippuku	dose
一戦	issen	battle
一息	hitoiki	one breath
一眼	itigan	one eye
一躍	itiyaku	suddenly
一気	ikki	chug!
一見	ikken	look
一文	itibun	sentence
一撃	itigeki	blow
一石	isseki	one game
一礼	itirei	bow
一蹴	issyuu	kicking
一味	itimi	clan
一色	issyoku	one color
一過	ikka	passing away
一口	hitokuti	mouthful
一望	itiboo	one sweep
一翼	itiyoku	wing
一同	itidoo	all present
一巡	itizyun	beat
一助	itizyo	help
一身	issin	oneself
一発	ippatu	one shot
一座	itiza	party
一声	issei	voice
一読	itidoku	perusal
一世	issei	generation
一昔	hitomukasi	ages
一子	issi	a child
一団	itidan	body
一揆	ikki	uprising
一句	ikku	phrase
一矢	issi	an arrow
一言	itigen	single word
一葉	itiyoo	one leaf
一躍	itiyaku	suddenly
一命	itimei	life
一抹	itimatu	touch of
一事	itizi	one thing
一足	hitoasi	step
一語	itigo	one word
一念	itinen	determined purpose
一路	itiro	one road
一考	ikkoo	consideration
一派	ippa	school
一級	ikkyuu	one grade
一晩	hitoban	one night
一案	itian	idea
一理	itiri	principle
一月	itigatu	January
一間	ikken	one ken
一式	issiki	complete set
一説	issetu	one theory
一風	ippuu	eccentric
一刻	ikkoku	minute
一笑	issyoo	laugh
一片	ippen	slice
一役	hitoyaku	role
一芸	itigei	an art
一代	itidai	generation
一群	itigun	group
一樹	itizyu	one tree
一滴	itteki	drop
一隅	itiguu	corner
一足	issoku	pair
一興	ikkyoo	amusement
一睡	issui	a wink of sleep
一極	ikkyoku	monopole
一糸	issi	thread
一筆	ippitu	a few lines
一目	hitome	glance
一策	issaku	idea
一徹	ittetu	obstinate
一利	itiri	one advantage
一輪	itirin	one flower
一党	ittoo	party
一存	itizon	one's own discretion
一対	ittui	pair
一途	itizu	wholehearted
一等	ittoo	first-class
一顧	ikko	notice of
一介	ikkai	mere
一刀	ittoo	sword
一遍	ippen	once
一粒	hitotubu	grain
一皮	hitokawa	unmasking
一癖	hitokuse	trait
一首	issyu	tanka
一道	itidoo	one road
一脈	itimyaku	vein
一物	itimotu	plot
一類	itirui	same kind
一山	hitoyama	one mountain
一朝	ittyoo	temporarily
一計	ikkei	plan
一重	hitoe	one layer
一双	issoo	pair
一点	itten	speck
一如	itinyo	oneness
一席	isseki	sitting
一巻	ikkan	one roll
一死	issi	dying
一閃	issen	flash
一縷	itiru	a thread
一反	ittan	one-tenth hectare
一瞥	itibetu	glance
一丁	ittyoo	one sheet
一泡	hitoawa	blow
一花	hitohana	success
一角	hitokado	a cut above the rest
一献	ikkon	one cup
一軒	ikken	one house
一寸	issun	one sun
一難	itinan	one difficulty
一塊	hitokatamari	one lump
一旗	hitohata	flag
一女	itizyo	daughter
一聴	ittyoo	listening to once
一々	itiiti	one-by-one
一天	itten	the whole sky
一夕	isseki	one evening
一泊	ippaku	stopping one night
一戸	ikko	one house
一筆	hitohude	a few lines
一両	itiryoo	one vehicle
一敗	ippai	one defeat
一驚	ikkyoo	surprise
一己	ikko	personal
一陣	itizin	gust of wind
一通	ittuu	one copy
一拍	ippaku	one clap
一雨	hitoame	shower
一汗	hitoase	doing a job
一季	ikki	one season
一義	itigi	reason
一軍	itigun	an army
一再	issai	once or twice
一札	issatu	document
一決	ikketu	agreed
一向	hitaburu	nothing but
一半	ippan	half
一頃	hitokoro	once
一束	issoku	a bundle
一面	itimen	one face
一一	itiiti	one-by-one
一指	issi	finger
一隻	isseki	one boat
一統	ittoo	lineage
一齣	hitokoma	one scene
一郭	ikkaku	one block
一髪	ippatu	hair
一疋	ippiki	one animal
一葦	itii	one reed
一意	itii	unique
一塩	hitosio	slightly salted
一期	ikki	one term
一掬	ikkiku	small amount
一軸	itiziku	uniaxial
一週	issyuu	one week
一所	issyo	one place
一千	issen	1,000
一腹	ippuku	one litter
一眸	itiboo	one sweep
統一	tooitu	unity
唯一	yuiitu	only
同一	dooitu	identity
単一	tanitu	single
万一	maniti	emergency
画一	kakuitu	uniformity
随一	zuiiti	best
均一	kinitu	uniformity
均一	kinitu	uniformity
純一	zyunitu	purity
同一	dooitu	identity
合一	gooitu	unification
帰一	kiitu	united into one
専一	senitu	exclusively
三一	sanpin	low-ranking samurai
一一	itiiti	one-by-one
斉一	seiitu	equality
右翼	uyoku	right-wing
右腕	uwan	right arm
右左	migihidari	right and left
右足	migiasi	right foot
右手	migite	right hand
右派	uha	right wing
右肩	migikata	right shoulder
右端	migihasi	right end
右側	migigawa	right side
右辺	uhen	right side
右上	migiue	right-upper
右下	migisita	right-lower
右目	migime	right eye
右折	usetu	turning to the right
右傾	ukei	rightist
右脳	unoo	right brain
右舷	ugen	starboard
右岸	ugan	right bank
右記	uki	aforementioned
右筆	yuuhitu	private secretary
左右	sayuu	left and right
極右	kyokuu	extreme right
座右	zayuu	at one's right
雨天	uten	rainy weather
雨水	amamizu	rain water
雨量	uryoo	rainfall
雨林	urin	rain forest
雨期	uki	rainy season
雨具	amagu	rain gear
雨雲	amagumo	rain cloud
雨中	utyuu	in the rain
雨傘	amagasa	umbrella
雨風	amekaze	rain and wind
雨粒	amatubu	raindrop
雨後	ugo	after rain
雨脚	amaasi	passing shower
雨露	uro	rain and dew
雨滴	uteki	raindrops
雨空	amazora	rainy sky
雨季	uki	rainy season
雨夜	amayo	rainy night
雨曇	amagumori	overcast weather
雨樋	amadoi	drainspout
雨下	uka	raining
雨蛙	amagaeru	tree frog
雨気	amake	signs of rain
雨間	amaai	break in the rain
豪雨	goou	torrential rain
梅雨	tuyu	rainy season
大雨	ooame	heavy rain
降雨	koou	rainfall
小雨	kosame	light rain
雷雨	raiu	thunderstorm
風雨	huuu	wind and rain
時雨	sigure	drizzle
春雨	harusame	gentle spring rain
長雨	nagaame	long spell of rain
霧雨	kirisame	drizzle
秋雨	akisame	autumn rain
多雨	tau	heavy rain
白雨	hakuu	rain shower
慈雨	ziu	welcome rain
氷雨	hisame	hail
晴雨	seiu	weather
涙雨	namidaame	light rain
冷雨	reiu	chilly rain
村雨	murasame	passing shower
驟雨	syuuu	sudden shower
弾雨	danu	hail of bullets
一雨	hitoame	shower
細雨	saiu	drizzle
微雨	biu	light rain
黴雨	tuyu	rainy season
円滑	enkatu	smooth
円形	enkei	round shape
円満	enman	perfection
円筒	entoo	cylinder
円熟	enzyuku	ripeness
円卓	entaku	round table
円盤	enban	disk
円周	ensyuu	circumference
円陣	enzin	forming a circle
円柱	entyuu	column
円弧	enko	arc
円錐	ensui	cone
円光	enkoo	halo
円座	enza	sitting in circle
円本	enpon	one-yen book
円蓋	engai	cupola
円貨	enka	yen currency
円舞	enbu	waltz
円心	ensin	centre of circle
楕円	daen	ellipse
半円	hanen	semicircle
方円	hooen	squares and circles
長円	tyooen	ellipse
大円	daien	large circle
金円	kinen	money
下落	geraku	depreciation
下旬	gezyun	month
下方	kahoo	lower region
下車	gesya	alighting
下着	sitagi	underwear
下位	kai	low rank
下部	kabu	lower part
下流	karyuu	downstream
下山	gezan	descending
下痢	geri	diarrhoea
下降	kakoo	downward
下限	kagen	lower limit
下地	sitazi	groundwork
下宿	gesyuku	boarding
下見	sitami	preview
下水	gesui	drainage
下記	kaki	the following
下田	geden	worn-out rice land
下段	gedan	lower tier
下級	kakyuu	lower grade
下火	sitabi	burning low
下草	sitakusa	undergrowth
下層	kasoo	lower strata
下品	gehin	vulgarity
下巻	gekan	last volume
下駄	geta	geta
下絵	sitae	rough sketch
下味	sitaazi	seasoning of food
下肢	kasi	the legs
下敷	sitaziki	desk pad
下値	sitane	lowest price
下界	gekai	this world
下座	geza	squatting
下船	gesen	going ashore
下馬	geba	dismounting
下心	sitagokoro	secret intention
下剤	gezai	laxative
下請	sitauke	subcontract
下劣	geretu	base
下腹	kahuku	abdomen
下垂	kasui	drooping
下品	gehin	vulgarity
下司	gesu	low-life
下足	gesoku	footwear
下々	simozimo	the lower classes
下賜	kasi	grant
下図	sitazu	rough sketch
下端	katan	lower end
下命	kamei	order
下女	gezyo	maid servant
下僕	geboku	manservant
下弦	kagen	last quarter
下知	geti	command
下等	katoo	inferior
下帯	sitaobi	loincloth
下腿	katai	lower leg
下屋	geya	small attached annex
下向	gekoo	leaving the capital
下面	kamen	underside
下人	genin	low-rank person
下男	genan	manservant
下問	kamon	enquiry
下策	gesaku	poor plan
下線	kasen	underline
下肥	simogoe	manure
下表	kahyoo	diagram below
下付	kahu	grant
下衆	gesu	low-life
下役	sitayaku	underling
下名	kamei	undermentioned
下作	sitasaku	poor manufacture
下等	katoo	inferior
下風	kahuu	subordinate position
下目	sitame	downward glance
下獄	gegoku	being sent to prison
下僚	karyoo	subordinates
下下	simozimo	the lower classes
下種	gesu	low-life
下乗	gezyoo	dismounting
下郎	geroo	servant
下番	kaban	going off duty
下露	sitatuyu	trees
以下	ika	not exceeding
低下	teika	fall
地下	tika	basement
傘下	sanka	affiliated with
上下	zyooge	top and bottom
陛下	heika	your Majesty
落下	rakka	fall
部下	buka	subordinate person
投下	tooka	throwing down
却下	kyakka	rejection
廊下	rooka	corridor
左下	hidarisita	lower left
天下	tenka	the whole world
床下	yukasita	under the floor
年下	tosisita	younger
直下	tyokka	directly under
降下	kooka	fall
靴下	kutusita	socks
右下	migisita	right-lower
殿下	denka	your Highness
南下	nanka	going south
格下	kakusita	lower rank
沈下	tinka	sinking
目下	mokka	at present
高下	kooge	rise and fall
眼下	ganka	under one's eyes
風下	kazasimo	leeward
真下	masita	right under
配下	haika	subordinates
階下	kaika	lower floor
皮下	hika	subcutaneous
目下	mesita	subordinate
閣下	kakka	your Excellency
川下	kawasimo	downstream
現下	genka	the present time
城下	zyooka	land near the castle
西下	saika	going west
最下	saika	the lowest
卑下	hige	self-abasement
都下	toka	in the capital
月下	gekka	in the moonlight
言下	gonka	promptly
臣下	sinka	retainer
泉下	senka	Hades
最下	saika	the lowest
県下	kenka	in the prefecture
手下	tesita	subordinate
足下	asimoto	at one's feet
嚥下	enka	swallowing
樹下	zyuka	beneath the trees
版下	hansita	artwork
零下	reika	below zero
府下	huka	suburban districts
流下	ryuuka	flowing down
時下	zika	nowadays
垂下	suika	being pendent
台下	daika	your honor
脚下	kyakka	at one's feet
猊下	geika	your highness
放下	hooka	discarding
貴下	kika	you
治下	tika	under the rule of
滴下	tekika	drip
膝下	hizamoto	near one's knee
雨下	uka	raining
股下	matasita	length of the legs
下下	simozimo	the lower classes
三下	sansita	petty underling
灯下	tooka	by the lamp
翼下	yokuka	underwing
麾下	kika	under the command
割下	warisita	sukiyaki stock
隷下	reika	subordinates
火災	kasai	conflagration
火山	kazan	volcano
火事	kazi	fire
火星	kasei	Mars
火力	karyoku	heating power
火種	hidane	live coals
火曜	kayoo	Tuesday
火薬	kayaku	gunpowder
火花	hibana	spark
火口	kakoo	crater
火葬	kasoo	cremation
火元	himoto	origin of a fire
火鉢	hibati	brazier
火焔	kaen	flame
火器	kaki	firearms
火中	katyuu	in the fire
火柱	hibasira	pillar of fire
火炎	kaen	flame
火傷	kasyoo	burn
火勢	kasei	force of flames
火砲	kahoo	artillery
火気	kaki	fire
火刑	kakei	burning at the stake
火祭	himaturi	fire festival
火水	himizu	fire and water
火皿	hizara	fire grate
火縄	hinawa	fuse
火消	hikesi	extinguishing a fire
火屋	hoya	lamp chimney
火蓋	hibuta	apron of a gun
火急	kakyuu	emergency
火焼	hitaki	Old World flycatcher
火影	hokage	firelight
火酒	kasyu	strong drink
火急	kakyuu	emergency
火矢	hiya	fire arrow
火玉	hidama	falling star
火色	hiiro	color of flames
火夫	kahu	fireman
火燵	kotatu	kotatsu
火難	kanan	fire calamity
火桶	hioke	wooden brazier
火箭	kasen	fire arrow
火線	kasen	firing line
放火	hooka	arson
噴火	hunka	eruption
出火	syukka	outbreak of fire
花火	hanabi	fireworks
聖火	seika	sacred fire
消火	syooka	fire fighting
発火	hakka	firing
戦火	senka	wartime fire
防火	booka	fire prevention
点火	tenka	ignition
口火	kutibi	fuse
引火	inka	catching fire
耐火	taika	fireproof
鎮火	tinka	extinguishing
灯火	tomosibi	light
弱火	yowabi	simmering
砲火	hooka	gunfire
着火	tyakka	ignited
下火	sitabi	burning low
強火	tuyobi	high flame or heat
炭火	sumibi	charcoal fire
失火	sikka	accidental fire
大火	taika	large fire
煙火	enka	smoke and fumes
烈火	rekka	raging fire
狐火	kitunebi	St. Elmo's fire
銃火	zyuuka	gunfire
鉄火	tekka	red-hot iron
焚火	takibi	open-air fire
鬼火	onibi	will-o'-the-wisp
蛍火	hotarubi	light of a firefly
業火	gooka	hell fire
神火	sinka	sacred flame
小火	boya	small fire
炬火	kyoka	pine torch
鉄火	tekka	red-hot iron
烽火	hooka	beacon
行火	anka	bed warmer
兵火	heika	fire caused by war
遠火	toobi	distant fire
水火	suika	fire and water
雷火	raika	flash of lightning
燐火	rinka	phosphorous light
熾火	okibi	glowing ember
狼火	rooka	signal fire
何者	nanimono	who
何事	nanigoto	what
何人	nanibito	everyone
何処	doko	where
何時	itu	when
何分	nanibun	some
何様	nanisama	person of importance
何頭	nantoo	how many?
何方	donata	who?
何程	nanihodo	how much
何某	naniboo	certain person
幾何	kika	geometry
如何	ika	how
誰何	suika	challenging
外交	gaikoo	diplomacy
外相	gaisyoo	Foreign Minister
外国	gaikoku	foreign country
外野	gaiya	outfield
外務	gaimu	foreign affairs
外部	gaibu	the outside
外為	gaitame	foreign exchange
外資	gaisi	foreign capital
外出	gaisyutu	outing
外来	gairai	foreign
外角	gaikaku	outside corner
外科	geka	surgery
外貨	gaika	foreign currency
外食	gaisyoku	eating out
外傷	gaisyoo	external wound
外側	sotogawa	exterior
外観	gaikan	appearance
外壁	gaiheki	outer wall
外遊	gaiyuu	foreign travel
外形	gaikei	externals
外見	gaiken	outward appearance
外郭	gaikaku	outer wall
外需	gaizyu	foreign consumption
外苑	gaien	outer garden
外圧	gaiatu	external pressure
外装	gaisoo	exterior
外注	gaityuu	outside order
外局	gaikyoku	external bureau
外語	gaigo	foreign language
外債	gaisai	foreign loan
外界	gaikai	outside world
外事	gaizi	foreign affairs
外車	gaisya	foreign automobile
外気	gaiki	open air
外堀	sotobori	outer moat
外敵	gaiteki	foreign enemy
外人	gaizin	foreigner
外周	gaisyuu	outer circumference
外洋	gaiyoo	open sea
外政	gaisee	foreign policy
外的	gaiteki	external
外用	gaiyoo	external use
外面	gaimen	outer surface
外患	gaikan	external pressure
外地	gaiti	overseas territories
外郎	uiroo	sweet rice jelly
外電	gaiden	foreign telegram
外様	tozama	outside daimyo
外套	gaitoo	overcoat
外山	toyama	nearby mountain
外縁	gaien	brink
外縁	gaien	brink
外皮	gaihi	skin
外宮	gekuu	Outer shrine of Ise
外商	gaisyoo	foreign businessman
外向	gaikoo	extroversion
外販	gaihan	direct sales
外濠	sotobori	outer moat
外聞	gaibun	reputation
外耳	gaizi	external ear
外力	gairyoku	external force
外灯	gaitoo	outside light
外因	gaiin	the surface reason
外史	gaisi	unofficial history
外報	gaihoo	foreign news
外延	gaien	extension
外輪	gairin	wheel rim
外在	gaizai	external
外戚	gaiseki	maternal relative
外米	gaimai	foreign rice
外層	gaisoo	outer layers
外題	gedai	title
外教	gaikyoo	foreign religion
外征	gaisei	foreign campaign
外典	geten	Apocrypha
外貌	gaiboo	outward appearance
外賓	gaihin	foreign guest
外方	soppo	the other way
外法	sotonori	outside measurements
海外	kaigai	foreign
郊外	koogai	suburb
意外	igai	unexpected
国外	kokugai	outside the country
内外	naigai	inside and outside
例外	reigai	exception
除外	zyogai	exception
対外	taigai	external
屋外	okugai	outdoors
在外	zaigai	overseas
社外	syagai	outside the company
体外	taigai	ectogenesis
野外	yagai	outdoors
論外	rongai	out of the question
場外	zyoogai	outside the hall
番外	bangai	exception
疎外	sogai	estrangement
域外	ikigai	outside the area
枠外	wakugai	limits
号外	googai	newspaper extra
車外	syagai	outside a car
閣外	kakugai	outside the Cabinet
渉外	syoogai	public relations
圏外	kengai	outside range
戸外	kogai	open-air
法外	hoogai	exorbitant
心外	singai	regrettable
課外	kagai	extracurricular
室外	situgai	outdoors
案外	angai	unexpectedly
校外	koogai	off-campus
排外	haigai	anti-foreign
学外	gakugai	outside the school
口外	koogai	disclosure
言外	gengai	unexpressed
欄外	rangai	margin
天外	tengai	beyond the heavens
望外	boogai	unexpected
選外	sengai	unselected
門外	mongai	outside a gate
院外	ingai	outside congress
機外	kigai	outside a plane
中外	tyuugai	home and abroad
望外	boogai	unexpected
局外	kyokugai	the outside
人外	zingai	uninhabited area
員外	ingai	non-membership
構外	koogai	off grounds
遣外	kengai	dispatched abroad
埒外	ratigai	out of bounds
理外	rigai	supra-rational
格外	kakugai	nonstandard
等外	toogai	also-ran
慮外	ryogai	unexpected
学校	gakkoo	school
学生	gakusei	student
学園	gakuen	academy
学習	gakusyuu	study
学会	gakkai	scientific society
学者	gakusya	scholar
学長	gakutyoo	university president
学力	gakuryoku	scholarly ability
学院	gakuin	institute
学年	gakunen	year in school
学芸	gakugei	arts and sciences
学級	gakkyuu	class
学科	gakka	study subject
学術	gakuzyutu	science
学問	gakumon	scholarship
学期	gakki	school term
学歴	gakureki	academic background
学費	gakuhi	tuition
学識	gakusiki	scholarship
学童	gakudoo	school child
学的	gakuteki	scholarly
学内	gakunai	within the school
学業	gakugyoo	studies
学徒	gakuto	student
学位	gakui	degree
学士	gakusi	university graduate
学説	gakusetu	theory
学区	gakku	school district
学研	gakken	study and research
学際	gakusai	interdisciplinary
学修	gakusyuu	study
学外	gakugai	outside the school
学名	gakumei	technical name
学友	gakuyuu	school friend
学資	gakusi	school expenses
学卒	gakusotu	college graduate
学派	gakuha	school
学究	gakkyuu	scholar
学割	gakuwari	student discount
学齢	gakurei	school age
学舎	gakusya	school
学籍	gakuseki	school register
学事	gakuzi	educational affairs
学寮	gakuryoo	student hostel
学閥	gakubatu	alma mater clique
学務	gakumu	school affairs
学風	gakuhuu	academic traditions
学則	gakusoku	school regulations
学理	gakuri	scholarly principle
学殖	gakusyoku	scholarship
学課	gakka	lesson
学帽	gakuboo	school cap
学窓	gakusoo	school
学徳	gakutoku	learning and virtue
学才	gakusai	academic ability
学匠	gakusyoo	scholar
科学	kagaku	science
文学	bungaku	literature
中学	tyuugaku	middle school
化学	kagaku	chemistry
医学	igaku	medical science
小学	syoogaku	elementary school
留学	ryuugaku	studying abroad
哲学	tetugaku	philosophy
数学	suugaku	mathematics
見学	kengaku	inspection
工学	koogaku	engineering
通学	tuugaku	commuting to school
在学	zaigaku	in school
就学	syuugaku	entering school
語学	gogaku	language study
私学	sigaku	school
光学	koogaku	optics
法学	hoogaku	law
美学	bigaku	esthetics
理学	rigaku	physical science
疫学	ekigaku	epidemiology
力学	rikigaku	mechanics
遊学	yuugaku	studying abroad
産学	sangaku	industry-academic
独学	dokugaku	self-education
神学	singaku	theology
農学	noogaku	agriculture
薬学	yakugaku	pharmacy
史学	sigaku	study of history
共学	kyoogaku	coeducation
勉学	bengaku	study
志学	sigaku	age 15
地学	tigaku	earth sciences
全学	zengaku	whole college
復学	hukugaku	return to school
修学	syuugaku	learning
儒学	zyugaku	Confucianism
歯学	sigaku	dentistry
実学	zitugaku	practical science
蘭学	rangaku	Dutch studies
漢学	kangaku	Sinology
碩学	sekigaku	great scholar
同学	doogaku	the same school
詩学	sigaku	study of poetry
商学	syoogaku	commercial science
夜学	yagaku	evening course
無学	mugaku	illiteracy
視学	sigaku	school inspector
転学	tengaku	to another
本学	hongaku	this university
道学	doogaku	ethics
博学	hakugaku	erudition
官学	kangaku	government school
洋学	yoogaku	Western learning
林学	ringaku	forestry
経学	keigaku	Confucianism
軍学	gungaku	military science
博学	hakugaku	erudition
易学	ekigaku	study of divination
兵学	heigaku	military science
禅学	zengaku	Zen studies
好学	koogaku	love of learning
先学	sengaku	academic predecessor
晩学	bangaku	late education
後学	koogaku	younger scholar
俗学	zokugaku	popular learning
不学	hugaku	unlearned
古学	kogaku	classical studies
衒学	gengaku	pedantry
家学	kagaku	hereditary learning
歌学	kagaku	poetry
篤学	tokugaku	love of learning
仏学	butugaku	Buddhist learning
間接	kansetu	indirection
間際	magiwa	on the verge of
間近	mazika	proximity
間隔	kankaku	space
間伐	kanbatu	periodic thinning
間柄	aidagara	relation
間口	maguti	frontage
間髪	kanpatu	in no time
間食	kansyoku	eating between meals
間断	kandan	break in time
間隙	kangeki	gap
間奏	kansoo	interlude
間尺	masyaku	marked
間道	kandoo	side road
間欠	kanketu	intermittence
間諜	kantyoo	spy
間遠	madoo	at long distance
間作	kansaku	catch crop
間柱	mabasira	stud
間者	kanzya	spy
間歇	kanketu	intermittence
間代	madai	room rent
間着	aigi	between-season wear
時間	zikan	time
年間	nenkan	year
人間	ningen	human being
民間	minkan	private
期間	kikan	period
年間	nenkan	year
週間	syuukan	week
中間	tyuukan	middle
仲間	nakama	company
瞬間	syunkan	moment
空間	kuukan	space
分間	hunkan	~ minutes interval
区間	kukan	section
世間	seken	world
夜間	yakan	at night
月間	gekkan	month-long period
手間	tema	time
週間	syuukan	week
昼間	hiruma	daytime
合間	aima	interval
山間	sankan	among the mountains
居間	ima	living room
区間	kukan	section
朝間	asama	during the morning
谷間	tanima	valley
行間	gyookan	line-spacing in text
狭間	hazama	interval
土間	doma	dirt floor
一間	ikken	one ken
眉間	miken	brow
林間	rinkan	in the forest
隙間	sukima	crevice
波間	namima	on the waves
広間	hiroma	hall
雲間	kumoma	rift between clouds
洋間	yooma	Western-style room
客間	kyakuma	parlor
股間	kokan	nether region
幇間	hookan	professional jester
幕間	makuai	intermission
巷間	kookan	on the street
離間	rikan	estrangement
欄間	ranma	transom
食間	syokkan	between meals
雪間	yukima	break in the snow
小間	koma	small room
肋間	rokkan	intercostal
旬間	zyunkan	period of ten days
深間	hukama	depths
貸間	kasima	room to let
雨間	amaai	break in the rain
軌間	kikan	gauge
近間	tikama	proximity
寝間	nema	bedroom
晴間	harema	break
潮間	sioma	ebb tide
半間	hanma	something unfinished
半間	hanma	something unfinished
借間	syakuma	rented room
俗間	zokkan	the world
別間	betuma	separate room
坊間	bookan	all over town
気分	kibun	feeling
気候	kikoo	climate
気味	gimi	#NAME?
気象	kisyoo	weather
気配	kehai	indication
気合	kiai	scream
気圧	kiatu	atmospheric pressure
気軽	kigaru	carefree
気迫	kihaku	spirit
気力	kiryoku	willpower
気楽	kiraku	carefree
気概	kigai	strong spirit
気鋭	kiei	spirited
気質	kisitu	spirit
気流	kiryuu	atmospheric current
気性	kisyoo	disposition
気管	kikan	trachea
気勢	kisei	fervour
気球	kikyuu	balloon
気丈	kizyoo	stout-hearted
気品	kihin	elegance
気密	kimitu	airtight
気道	kidoo	respiratory tract
気味	kimi	sensation
気功	kikoo	breathing exercise
気風	kihuu	character
気化	kika	vaporization
気持	kimoti	feeling
気骨	kikotu	backbone
気圧	kiatu	atmospheric pressure
気体	kitai	vapour
気筒	kitoo	cylinder
気泡	kihoo	bubble
気心	kigokoro	temper
気弱	kiyowa	timid
気前	kimae	generosity
気絶	kizetu	faint
気長	kinaga	patient
気宇	kiu	breadth of mind
気鋭	kiei	spirited
気胸	kikyoo	pneumothorax
気脈	kimyaku	blood vessel
気息	kisoku	breathing
気孔	kikoo	pore
気色	kesiki	sign
気炎	kien	high spirits
気位	kigurai	pride
気付	kituke	care of
気弱	kiyowa	timid
気韻	kiin	dignity
気運	kiun	luck
気短	kimizika	short-tempered
気団	kidan	air mass
気魄	kihaku	spirit
気根	kikon	aerial root
気侭	kimama	willful
気嚢	kinoo	air bladder or sac
気鬱	kiutu	gloom
気圏	kiken	atmosphere
気侭	kimama	willful
気重	kiomo	heavy-hearted
気重	kiomo	heavy-hearted
気随	kizui	willful
人気	ninki	popularity
景気	keiki	condition
病気	byooki	illness
元気	genki	health
電気	denki	electricity
空気	kuuki	air
勇気	yuuki	courage
大気	taiki	atmosphere
強気	tuyoki	confident
天気	tenki	weather
本気	honki	seriousness
熱気	nekki	heat
排気	haiki	exhaust
蒸気	zyooki	steam
活気	kakki	energy
嫌気	iyake	dislike
酒気	syuki	liquor smell
陽気	yooki	cheerful
士気	siki	morale
磁気	ziki	magnetism
換気	kanki	ventilation
語気	goki	tone
寒気	samuke	chill
平気	heiki	coolness
一気	ikki	chug!
本気	honki	seriousness
色気	iroke	colouring
浮気	uwaki	extramarital sex
意気	iki	spirit
狂気	kyooki	madness
弱気	yowaki	timid
平気	heiki	coolness
湿気	sikke	moisture
根気	konki	patience
水気	mizuke	moisture
呼気	koki	exhalation
眠気	nemuke	sleepiness
弱気	yowaki	timid
通気	tuuki	ventilation
湯気	yuge	steam
外気	gaiki	open air
冷気	reiki	cold
覇気	haki	ambition
生気	seiki	life
鬼気	kiki	ghastly
短気	tanki	quick temper
内気	utiki	bashfulness
上気	zyooki	flushing
才気	saiki	wisdom
臭気	syuuki	bad smell
男気	otokoke	male presence
陽気	yooki	cheerful
正気	syooki	sanity
悪気	warugi	ill will
英気	eiki	great wisdom
精気	seiki	spirit
邪気	zyaki	maliciousness
陰気	inki	gloom
吸気	kyuuki	inhalation
汁気	siruke	juice
正気	syooki	sanity
噴気	hunki	gas
毒気	dokuke	poisonous nature
健気	kenage	brave
暖気	danki	warmth
血気	kekki	vigor
香気	kooki	fragrance
殺気	sakki	thirst for blood
若気	wakage	youthful impetuosity
暑気	syoki	hot weather
運気	unki	fate
呑気	nonki	carefree
霊気	reiki	aura
怒気	doki	anger
脚気	kakke	beriberi
浮気	uwaki	extramarital sex
火気	kaki	fire
堅気	katagi	honest
塩気	sioke	saltiness
快気	kaiki	recovery
暖気	nonki	carefree
侠気	otokogi	chivalrous spirit
稚気	tiki	childishness
妖気	yooki	ghostly
豪気	gooki	great
勝気	katiki	determined spirit
呆気	akke	taken aback
暢気	nonki	carefree
夜気	yaki	night air
瘴気	syooki	miasma
陰気	inki	gloom
俗気	zokuki	vulgarity
涼気	ryooki	cool air
金気	kanake	metallic taste
疝気	senki	colic
辛気	sinki	mentality
海気	kaiki	sea air
客気	kakki	youthful ardor
豪気	gooki	great
秋気	syuuki	autumn air
心気	sinki	mentality
雨気	amake	signs of rain
脂気	aburake	oiliness
中気	tyuuki	palsy
悋気	rinki	jealousy
鋭気	eiki	courage
志気	siki	determination
温気	unki	heat
勘気	kanki	disfavor
産気	sanke	labor pains
女気	onnake	female presence
笑気	syooki	nitrous oxide
損気	sonki	disadvantage
怖気	ozoke	fear
安気	anki	ease
雲気	unki	cloud
義気	giki	chivalry
山気	yamaki	speculative spirit
乗気	noriki	interest
神気	sinki	the elements
辛気	sinki	mentality
瑞気	zuiki	good omen
虫気	musike	nervous weakness
吐気	hakike	nausea
油気	aburake	oiliness
鬱気	ukki	gloomy
九重	kokonoe	ninefold
九月	kugatu	September
九九	kuku	multiplication table
九分	kubu	nine parts
九天	kyuuten	sky
九輪	kurin	kurin
九泉	kyuusen	hades
九九	kuku	multiplication table
休日	kyuuzitu	holiday
休養	kyuuyoo	rest
休暇	kyuuka	holiday
休憩	kyuukei	rest
休館	kyuukan	closure
休場	kyuuzyoo	theater closure
休業	kyuugyoo	closed
休止	kyuusi	pause
休職	kyuusyoku	temporary retirement
休校	kyuukoo	closing school
休戦	kyuusen	cease-fire
休会	kyuukai	adjournment
休息	kyuusoku	rest
休眠	kyuumin	idle
休廷	kyuutei	court recess
休講	kyuukoo	lecture cancellation
休耕	kyuukoo	lying fallow
休閑	kyuukan	fallowing
休戚	kyuuseki	weal and woe
休電	kyuuden	electricity cut-off
連休	renkyuu	consecutive holidays
運休	unkyuu	service suspended
定休	teikyuu	regular holiday
無休	mukyuu	without a holiday
育休	ikukyuu	childcare leave
全休	zenkyuu	whole
産休	sankyuu	maternity leave
遊休	yuukyuu	idle
週休	syuukyuu	weekly holiday
帰休	kikyuu	leave
有休	yuukyuu	vacation
公休	kookyuu	legal holiday
代休	daikyuu	compensatory holiday
半休	hankyuu	half holiday
金融	kinyuu	financing
金利	kinri	interest rates
金額	kingaku	amount of money
金属	kinzoku	metal
金曜	kinyoo	Friday
金銭	kinsen	money
金庫	kinko	safe
金星	kinbosi	dazzling victory
金色	kiniro	golden
金品	kinpin	money and goods
金魚	kingyo	goldfish
金城	kinzyoo	impregnable castle
金銀	kingin	gold and silver
金権	kinken	power of money
金賞	kinsyoo	prize
金券	kinken	gold certificate
金髪	kinpatu	blond hair
金網	kanaami	wire netting
金子	kinsu	money
金杯	kinpai	gold cup
金貨	kinka	gold coin
金納	kinnoo	cash payment
金箔	kinpaku	gold leaf
金山	kanayama	mine
金塊	kinkai	gold nugget
金剛	kongoo	vajra
金鉱	kinkoo	gold mine
金脈	kinmyaku	vein of gold
金物	kanamono	metal utensil
金策	kinsaku	raising money
金言	kingen	wise saying
金目	kaneme	monetary value
金時	kintoki	red
金工	kinkoo	metalwork
金棒	kanaboo	metal rod
金環	kinkan	gold ring
金粉	kinpun	gold dust
金欠	kinketu	running out of money
金糸	kinsi	gold thread
金製	kinsei	made of gold
金泥	kindei	gold paint
金力	kinryoku	monetary power
金輪	kanawa	metal ring
金管	kinkan	instrument
金石	kinseki	minerals and rocks
金敷	kanasiki	anvil
金員	kinin	money
金字	kinzi	gold or gilt letters
金歯	kinba	gold tooth
金襴	kinran	gold brocade
金縁	kinbuti	gilded edges or rims
金持	kanemoti	rich person
金冠	kinkan	gold crown
金玉	kintama	testicles
金的	kinteki	bull's-eye
金将	kinsyoo	gold general
金砂	kinsya	gold dust
金気	kanake	metallic taste
金座	kinza	Edo-period gold mint
金柑	kinkan	kumquat
金紗	kinsya	silk crepe
金槌	kanazuti	hammer
金位	kini	fineness of gold
金頭	kanagasira	redwing searobin
金牌	kinpai	gold medal
金肥	kanegoe	chemical fertilizer
金蔓	kanezuru	source of revenue
金円	kinen	money
金波	kinpa	golden waves
金高	kindaka	sum
金蛇	kanahebi	lacertid
金側	kingawa	a gold case
金釘	kanakugi	iron nail
金筋	kinsuzi	gold stripes
金串	kanagusi	metal spit
金鉄	kintetu	gold and iron
金盃	kinpai	gold cup
金盥	kanadarai	metal basin
資金	sikin	funds
年金	nenkin	annuity
現金	genkin	cash
料金	ryookin	fee
献金	kenkin	donation
基金	kikin	fund
預金	yokin	deposit
賞金	syookin	prize
賃金	tingin	wages
借金	syakkin	debt
税金	zeikin	tax
罰金	bakkin	fine
貯金	tyokin	putting money aside
代金	daikin	price
裏金	uragane	bribe
募金	bokin	fund-raising
送金	sookin	remittance
黄金	oogon	gold
貸金	kasikin	loan
公金	kookin	public funds
入金	nyuukin	deposit
返金	henkin	repayment
信金	sinkin	credit union
集金	syuukin	money collection
換金	kankin	realization
出金	syukkin	withdrawal
課金	kakin	charges
合金	gookin	alloy
針金	harigane	wire
千金	senkin	1000 pounds
敷金	sikikin	deposit
損金	sonkin	financial loss
板金	bankin	sheet metal
残金	zankin	remaining money
元金	gankin	capital
白金	hakkin	platinum
拝金	haikin	money-worship
純金	zyunkin	pure gold
給金	kyuukin	pay
礼金	reikin	finder's fee
頭金	atamakin	down payment
納金	nookin	payment
小金	kogane	small sum of money
地金	zigane	ore
砂金	syakin	gold dust
謝金	syakin	reward
寄金	kikin	contribution
彫金	tyookin	metal carving
前金	maekin	advance payment
冶金	yakin	metallurgy
現金	genkin	cash
用金	yookin	public money
差金	sasigane	carpenter's square
成金	narikin	upstart
益金	ekikin	profit
鋳金	tyuukin	casting
内金	utikin	deposit
贋金	nisegane	counterfeit money
口金	kutigane	cap
鍍金	mekki	gilt
座金	zagane	metal washer
即金	sokkin	payment in full
偽金	nisegane	counterfeit money
涙金	namidakin	consolation money
掛金	kakekin	installment
正金	syookin	specie
引金	hikigane	trigger
後金	atokin	rest of the payment
万金	mankin	immense sum
官金	kankin	government funds
赤金	akagane	copper
帯金	obigane	iron band
義金	gikin	contribution
産金	sankin	gold mining
賜金	sikin	monetary grant
償金	syookin	reparation
断金	dankin	close friendship
鬱金	ukon	turmeric
月額	getugaku	monthly amount
月間	gekkan	month-long period
月曜	getuyoo	Monday
月刊	gekkan	monthly publication
月例	geturei	monthly
月給	gekkyuu	monthly salary
月収	gessyuu	monthly income
月末	getumatu	end of the month
月面	getumen	moon's surface
月経	gekkei	menstruation
月齢	geturei	age of the moon
月報	geppoo	monthly report
月光	gekkoo	moonlight
月日	tukihi	time
月々	tukizuki	every month
月別	tukibetu	by months
月食	gessyoku	lunar eclipse
月評	geppyoo	monthly review
月産	gessan	monthly output
月見	tukimi	viewing the moon
月謝	gessya	monthly tuition fee
月夜	tukiyo	moonlit night
月々	tukizuki	every month
月次	getuzi	every month
月餅	geppei	mooncake
月影	tukikage	moonlight
月下	gekka	in the moonlight
月明	getumei	moonlight
月並	tukinami	every month
月琴	gekkin	yueqin
月蝕	gessyoku	lunar eclipse
月輪	geturin	moon
月賦	geppu	monthly installment
月桂	gekkei	laurel
月俸	geppoo	monthly salary
月頃	tukigoro	these past months
月極	tukigime	monthly
月利	geturi	monthly interest
月央	getuoo	middle of the month
月役	tukiyaku	menstruation
今月	kongetu	this month
先月	sengetu	last month
来月	raigetu	next month
同月	doogetu	the same month
毎月	maituki	every month
前月	zengetu	last month
正月	syoogatu	New Year
歳月	saigetu	time
年月	tosituki	months and years
翌月	yokugetu	following month
半月	hantuki	half-moon
五月	gogatu	May
満月	mangetu	full moon
蜜月	mitugetu	honeymoon
八月	hatigatu	August
新月	singetu	new moon
花月	kagetu	flowers and the moon
隔月	kakugetu	every second month
四月	sigatu	April
三月	sangatu	March
二月	nigatu	February
九月	kugatu	September
六月	rokugatu	June
十月	zyuugatu	October
名月	meigetu	harvest moon
望月	motizuki	full moon
七月	sitigatu	July
一月	itigatu	January
明月	meigetu	harvest moon
日月	zitugetu	sun and moon
半月	hantuki	half-moon
人月	ningetu	man month
秋月	syuugetu	autumn moon
ヶ月	kagetu	months
風月	huugetu	nature's beauty
当月	toogetu	this month
水月	suigetu	water and moon
寒月	kangetu	wintry moon
海月	kurage	jellyfish
無月	mugetu	moonless sky
限月	gengetu	contract month
ヵ月	kagetu	months
後月	atogetu	last month
朧月	oborozuki	hazy moon
箇月	kagetu	months
去月	kyogetu	last month
弦月	gengetu	crescent moon
閏月	zyungetu	intercalary month
旬月	zyungetu	month and ten days
例月	reigetu	every month
見方	mikata	viewpoint
見解	kenkai	opinion
見事	migoto	splendid
見学	kengaku	inspection
見物	kenbutu	sightseeing
見識	kensiki	views
見本	mihon	sample
見地	kenti	point of view
見分	kenbun	inspection
見当	kentoo	aim
見聞	kenbun	information
見積	mitumori	estimate
見習	minarai	learn by observation
見栄	mie	airs
見参	kenzan	seeing
見番	kenban	geisha call-office
見世	mise	store
見所	midokoro	point worthy of note
見境	misakai	distinction
見目	mime	appearance
見高	kendaka	pride
見付	mituke	approach
見返	mikaesi	endpaper
見込	mikomi	hope
見性	kensyoo	self-awareness
見台	kendai	bookrest
見様	miyoo	point of view
見頃	migoro	best time to see
見神	kensin	beatific vision
見処	midokoro	point worthy of note
見幕	kenmaku	threatening attitude
見料	kenryoo	admission fee
会見	kaiken	interview
意見	iken	opinion
発見	hakken	discovery
偏見	henken	prejudice
接見	sekken	interview
浅見	senken	shallow view
外見	gaiken	outward appearance
予見	yoken	foresight
後見	kooken	guardianship
一見	ikken	look
知見	tiken	expertise
下見	sitami	preview
拝見	haiken	seeing
所見	syoken	view
先見	senken	foresight
必見	hikken	must-see
政見	seiken	political views
形見	katami	memento
私見	siken	personal opinion
露見	roken	discovery
夢見	yumemi	having a dream
月見	tukimi	viewing the moon
識見	sikiken	views
味見	azimi	sampling
謁見	ekken	audience
姿見	sugatami	dresser
早見	hayami	chart
物見	monomi	sightseeing
細見	saiken	scrutiny
雪見	yukimi	snow viewing
了見	ryooken	idea
卓見	takken	clearsightedness
定見	teiken	fixed opinion
未見	miken	unacquainted
異見	iken	different opinion
風見	kazami	weather vane
書見	syoken	reading
毒見	dokumi	poison tasting
検見	kenmi	inspection
達見	takken	farsightedness
望見	booken	watching from afar
目見	mami	look
引見	inken	audience
創見	sooken	originality
管見	kanken	narrow insight
邪見	zyaken	evil point of view
謬見	byuuken	fallacy
瞥見	bekken	glance
我見	gaken	selfish mind
愚見	guken	one's humble opinion
他見	taken	viewing by others
卑見	hiken	my humble opinion
五輪	gorin	the Olympics
五感	gokan	the five senses
五月	gogatu	May
五味	gomi	five flavors
五体	gotai	the whole body
五色	gosiki	variegated colors
五行	gogyoo	wu xing
五穀	gokoku	the 5 grains
五指	gosi	the five fingers
五徳	gotoku	the five virtues
五線	gosen	staff
五戒	gokai	the five precepts
五音	goin	pentatonic scale
五臓	gozoo	the five viscera
五分	gobu	half
五加	ukogi	fiveleaf aralia
五絃	gogen	five strings
五分	gobu	half
五蘊	goun	the five skandhas
午後	gogo	afternoon
午前	gozen	morning
午睡	gosui	nap
午餐	gosan	lunch
午后	gogo	afternoon
午砲	gohoo	noon gun
正午	syoogo	noon
後半	koohan	second half
後援	kooen	support
後退	kootai	retreat
後任	koonin	successor
後継	kookei	succession
後期	kooki	latter period
後方	koohoo	behind
後輩	koohai	junior
後続	koozoku	succeeding
後悔	kookai	regret
後日	gozitu	in the future
後部	koobu	rear
後者	koosya	the latter
後世	koosei	posterity
後発	koohatu	starting late
後半	koohan	second half
後進	koosin	one's junior
後見	kooken	guardianship
後記	kooki	postscript
後味	atoazi	aftertaste
後年	koonen	future years
後尾	koobi	the rear
後列	kooretu	rear
後々	atoato	distant future
後逸	kooitu	pass
後編	koohen	latter part
後塵	koozin	second fiddle
後妻	gosai	second wife
後身	koosin	successor
後天	kooten	a posteriori
後山	atoyama	pusher
後釜	atogama	successor
後先	atosaki	front and rear
後述	koozyutu	later mention
後略	kooryaku	omitting the rest
後宮	kookyuu	inner palace
後代	koodai	posterity
後生	koosei	younger people
後景	kookei	background
後家	goke	widow
後衛	kooei	rear guard
後顧	kooko	looking back
後姿	usirosugata	retreating figure
後場	goba	afternoon session
後事	koozi	future affairs
後刻	gokoku	afterwards
後光	gokoo	halo
後難	koonan	future problems
後月	atogetu	last month
後口	atokuti	aftertaste
後嗣	koosi	heir
後足	atoasi	hind legs
後納	koonoo	deferred payment
後書	atogaki	afterword
後人	koozin	posterity
後学	koogaku	younger scholar
後端	kootan	end
後裔	kooei	descendant
後室	koositu	dowager
後金	atokin	rest of the payment
後産	atozan	placenta
後便	koobin	later mail
後目	sirime	backward glance
後患	kookan	future trouble
後作	atosaku	second crop
後胤	kooin	descendant
後架	kooka	toilet
後備	koobi	rear guard
後翅	koosi	hindwing
午後	gogo	afternoon
今後	kongo	from now on
最後	saigo	last
戦後	sengo	postwar period
以後	igo	after this
前後	zengo	front and rear
死後	sigo	after death
背後	haigo	back
生後	seigo	post-natal
老後	roogo	old age
没後	botugo	after death
事後	zigo	after-
術後	zyutugo	postoperative
食後	syokugo	after a meal
産後	sango	postpartum
読後	dokugo	after reading a book
銃後	zyuugo	the homefront
病後	byoogo	convalescence
予後	yogo	prognosis
雨後	ugo	after rain
落後	rakugo	dropping out of
人後	zingo	behind others
向後	koogo	hereafter
牛後	gyuugo	rump of cattle
爾後	zigo	thereafter
歿後	botugo	after death
別後	betugo	since we parted
浴後	yokugo	after bathing
語学	gogaku	language study
語気	goki	tone
語源	gogen	word root
語録	goroku	analects
語彙	goi	vocabulary
語句	goku	words
語感	gokan	sense of language
語尾	gobi	end of a word
語法	gohoo	diction
語調	gotyoo	tone
語呂	goro	sound
語義	gogi	meaning of a word
語族	gozoku	family of languages
語数	gosuu	number of words
語弊	gohei	faulty expression
語順	gozyun	word order
語意	goi	meaning of a word
語頭	gotoo	first part of a word
語原	gogen	word root
語勢	gosei	stress
語路	goro	sound
語形	gokei	word form
語部	kataribe	storyteller
語幹	gokan	stem
語根	gokon	of a word
物語	monogatari	tale
英語	eigo	English
落語	rakugo	rakugo
言語	gengo	language
国語	kokugo	national language
用語	yoogo	term
季語	kigo	seasonal word
単語	tango	word
標語	hyoogo	motto
敬語	keigo	honorific
造語	zoogo	coined word
仏語	hutugo	French
死語	sigo	dead language
豪語	googo	boasting
外語	gaigo	foreign language
熟語	zyukugo	kanji compound
新語	singo	new word
勅語	tyokugo	imperial rescript
口語	koogo	spoken language
私語	sigo	whispering
母語	bogo	mother tongue
一語	itigo	one word
主語	syugo	subject
隠語	ingo	secret language
略語	ryakugo	abbreviation
原語	gengo	original word
漢語	kango	Chinese word
独語	dokugo	monologue
古語	kogo	obsolete word
俗語	zokugo	colloquialism
文語	bungo	written language
類語	ruigo	quasi-synonym
人語	zingo	human speech
反語	hango	irony
成語	seigo	set phrase
結語	ketugo	conclusion
米語	beigo	American English
述語	zyutugo	predicate
失語	situgo	forgetting the words
逐語	tikugo	word-for-word
梵語	bongo	Sanskrit
詩語	sigo	poetic diction
妄語	moogo	lie
連語	rengo	compound word
雅語	gago	refined diction
祖語	sogo	protolanguage
廃語	haigo	obsolete word
激語	gekigo	harsh language
法語	hoogo	Buddhist sermon
洋語	yoogo	Western language
術語	zyutugo	technical term
評語	hyoogo	critical remarks
卑語	higo	vulgar expression
隻語	sekigo	just a few words
通語	tuugo	common speech
喃語	nango	lover's whispers
統語	toogo	syntactic
蜚語	higo	baseless rumor
縁語	engo	associated word
私語	sasamegoto	whispering
畳語	zyoogo	syllable repetition
難語	nango	difficult word
行政	gyoosei	administration
行動	koodoo	action
行為	kooi	act
行方	yukue	whereabouts
行使	koosi	use
行事	gyoozi	event
行進	koosin	march
行列	gyooretu	line
行員	kooin	bank clerk
行脚	angya	pilgrimage
行楽	kooraku	outing
行程	kootei	journey
行司	gyoozi	referee
行間	gyookan	line-spacing in text
行儀	gyoogi	manners
行商	gyoosyoo	monger
行書	gyoosyo	running script
行軍	koogun	march
行状	gyoozyoo	behavior
行幸	gyookoo	Imperial visit
行者	gyoozya	ascetic
行路	kooro	one's course
行人	koozin	passer-by
行水	gyoozui	tub bath
行旅	kooryo	traveling
行跡	gyooseki	behavior
行李	koori	portmanteau
行頭	gyootoo	beginning of line
行火	anka	bed warmer
行先	ikisaki	destination
行年	gyoonen	age at one's death
行文	koobun	writing
行啓	gyookei	attendance
行末	yukusue	fate
行末	yukusue	fate
行来	ikiki	coming and going
銀行	ginkoo	bank
発行	hakkoo	issue
執行	sikkoo	execution
現行	genkoo	present
実行	zikkoo	practice
旅行	ryokoo	travel
施行	sikoo	execution
先行	senkoo	preceding
飛行	hikoo	aviation
暴行	bookoo	assault
移行	ikoo	switching over to
犯行	hankoo	crime
進行	sinkoo	advance
同行	dookoo	accompanying
代行	daikoo	acting as agent
刊行	kankoo	publication
流行	ryuukoo	fashion
強行	kyookoo	forcing
運行	unkoo	service
歩行	hokoo	walk
履行	rikoo	performance
通行	tuukoo	passage
並行	heikoo	side-by-side
連行	renkoo	taking
続行	zokkoo	continuation
非行	hikoo	delinquency
航行	kookoo	cruise
断行	dankoo	decisive action
遂行	suikoo	accomplishment
横行	ookoo	walking sideways
平行	heikoo	concurrent
一行	ikkoo	line
修行	syugyoo	ascetic practices
逆行	gyakkoo	reverse movement
紀行	kikoo	traveller's journal
試行	sikoo	making an attempt
直行	tyokkoo	through
慣行	kankoo	customary practice
力行	rikkoo	strenuous efforts
壮行	sookoo	rousing
決行	kekkoo	doing
急行	kyuukoo	moving at high speed
各行	kakukoo	each line
敢行	kankoo	decisive action
随行	zuikoo	attendant
携行	keikoo	carrying
蛇行	dakoo	meandering
孝行	kookoo	filial piety
奉行	bugyoo	magistrate
他行	tagyoo	absence from home
血行	kekkoo	circulation
徐行	zyokoo	going slowly
凶行	kyookoo	violence
尾行	bikoo	shadow
愚行	gukoo	folly
専行	senkoo	acting arbitrarily
言行	genkoo	speech and behaviour
励行	reikoo	strict enforcement
予行	yokoo	rehearsal
平行	heikoo	concurrent
蛮行	bankoo	act of barbarity
淫行	inkoo	obscenity
素行	sokoo	behaviour
悪行	akugyoo	misdeed
道行	mitiyuki	going down the road
善行	zenkoo	good deed
巡行	zyunkoo	patrol
奇行	kikoo	eccentricity
遊行	yugyoo	wandering
改行	kaigyoo	new line
苦行	kugyoo	penance
退行	taikoo	retrogression
挙行	kyokoo	celebration
独行	dokkoo	going alone
品行	hinkoo	conduct
五行	gogyoo	wu xing
他行	takoo	absence from home
山行	sankoo	mountain hiking
鈍行	donkoo	ordinary train
洋行	yookoo	overseas travel
荒行	aragyoo	asceticism
当行	tookoo	our bank
乱行	rangyoo	violent conduct
知行	tigyoo	fief
勤行	gongyoo	religious service
併行	heikoo	side-by-side
緩行	kankoo	going slowly
跛行	hakoo	limp
孝行	kookoo	filial piety
遡行	sokoo	going upstream
単行	tankoo	going alone
奥行	okuyuki	depth
盛行	seikoo	frequency
順行	zyunkoo	going in order
密行	mikkoo	prowling about
兼行	kenkoo	doing simultaneously
難行	nangyoo	penance
角行	kakkoo	bishop
篤行	tokkoo	virtuous conduct
操行	sookoo	conduct
騎行	kikoo	horseback riding
印行	inkoo	publishing
兇行	kyookoo	violence
舟行	syuukoo	boating
醜行	syuukoo	conduct
所行	syogyoo	deed
微行	bikoo	traveling incognito
百行	hyakkoo	all acts
校長	kootyoo	principal
校舎	koosya	school building
校内	koonai	within a school
校庭	kootei	schoolyard
校閲	kooetu	revision
校歌	kooka	school song
校門	koomon	school gate
校正	koosei	proofreading
校区	kooku	school district
校外	koogai	off-campus
校則	koosoku	school regulations
校友	kooyuu	schoolmate
校風	koohuu	school tradition
校訂	kootei	revision
校章	koosyoo	school badge
校訓	kookun	school precepts
校医	kooi	school doctor
校旗	kooki	school flag
校規	kooki	school regulations
校合	kyoogoo	collation
校本	koohon	annotated textbook
高校	kookoo	senior high school
学校	gakkoo	school
登校	tookoo	attendance
同校	dookoo	same school
母校	bokoo	alma mater
将校	syookoo	commissioned officer
開校	kaikoo	opening a school
全校	zenkoo	the whole school
休校	kyuukoo	closing school
各校	kakukoo	each school
転校	tenkoo	change schools
他校	takoo	another school
分校	bunkoo	branch school
対校	taikoo	pertaining to school
閉校	heikoo	closing a school
本校	honkoo	main school
入校	nyuukoo	matriculation
来校	raikoo	school visit
検校	kengyoo	correction
藩校	hankoo	clan school
在校	zaikoo	being in school
当校	tookoo	this school
退校	taikoo	leaving school
貴校	kikoo	school
高校	kookoo	senior high school
高齢	koorei	age
高速	koosoku	high speed
高裁	koosai	High Court
高級	kookyuu	high class
高度	koodo	altitude
高騰	kootoo	sudden price jump
高官	kookan	high official
高額	koogaku	large sum
高値	takane	high price
高等	kootoo	high class
高原	koogen	tableland
高層	koosoo	multistory
高温	kooon	high temperature
高専	koosen	technical college
高揚	kooyoo	enhancement
高価	kooka	high price
高卒	koosotu	high school graduate
高地	kooti	high ground
高圧	kooatu	high voltage
高架	kooka	overhead structure
高熱	koonetu	high fever
高座	kooza	platform
高台	takadai	elevation
高波	takanami	high waves
高低	kootei	high and low
高給	kookyuu	high salary
高下	kooge	rise and fall
高山	koozan	high mountain
高炉	kooro	blast furnace
高音	takane	high-pitched tone
高潮	kootyoo	high tide
高率	kooritu	high rate
高次	koozi	higher-order-
高率	kooritu	high rate
高峰	kouhou	high mountain
高所	koosyo	high altitude
高名	koomyoo	fame
高僧	koosoo	high priest
高貴	kooki	high class
高慢	kooman	haughty
高瀬	takase	shallow river
高位	kooi	dignity
高利	koori	high interest rate
高根	takane	high peak
高床	takayuka	raised-floor
高潔	kooketu	purity
高木	kooboku	tall tree
高段	koodan	highly ranked
高大	koodai	lofty
高位	kooi	dignity
高額	koogaku	large sum
高慢	kooman	haughty
高弟	kootei	best pupil
高尚	koosyoo	high
高価	kooka	high price
高菜	takana	leaf mustard
高年	koonen	old age
高遠	kooen	noble
高嶺	takane	high peak
高風	koohuu	noble character
高配	koohai	good offices
高遠	kooen	noble
高大	koodai	lofty
高雅	kooga	refined
高進	koosin	rising
高貴	kooki	high class
高尚	koosyoo	high
高徳	kootoku	eminent virtue
高空	kookuu	high altitude
高踏	kootoo	highbrow
高坏	takatuki	serving table
高堂	koodoo	you
高楼	kooroo	building
高邁	koomai	noble
高邁	koomai	noble
高雅	kooga	refined
高説	koosetu	your opinion
高禄	kooroku	high salary
高角	kookaku	high-angle
高密	koomitu	high density
高覧	kooran	perusal
高言	koogen	boasting
高評	koohyoo	high reputation
高欄	kooran	railing
高吟	koogin	loud recitation
高足	koosoku	best student
高点	kooten	high score
高殿	takadono	stately mansion
高枕	takamakura	high pillow
高論	kooron	intelligent opinion
高閣	kookaku	tall building
高誼	koogi	kindness or favour
高鼾	takaibiki	loud snoring
最高	saikoo	highest
残高	zandaka	balance
標高	hyookoo	elevation
割高	waridaka	comparatively high
中高	nakadaka	convex
声高	kowadaka	with a loud voice
孤高	kokoo	isolation
崇高	suukoo	loftiness
激高	gekkoo	excited
元高	motodaka	principal
至高	sikoo	supreme
腰高	kosidaka	overbearing
最高	saikoo	highest
波高	hakoo	wave height
座高	zakoo	one's sitting height
石高	kokudaka	yield
登高	tookoo	climbing up
見高	kendaka	pride
目高	medaka	medaka ricefish
現高	gendaka	the present amount
権高	kendaka	pride
金高	kindaka	sum
甲高	koodaka	high-pitched
嵩高	kasadaka	bulky
総高	soodaka	total amount
国際	kokusai	international
国民	kokumin	nation
国会	kokkai	National Diet
国内	kokunai	internal
国家	kokka	state
国立	kokuritu	national
国土	kokudo	country
国交	kokkoo	diplomatic relations
国債	kokusai	national debt
国防	kokuboo	national defence
国務	kokumu	affairs of state
国境	kokkyoo	national border
国籍	kokuseki	nationality
国産	kokusan	domestic
国営	kokuei	state management
国王	kokuoo	king
国外	kokugai	outside the country
国政	kokusei	national politics
国庫	kokko	national treasury
国語	kokugo	national language
国技	kokugi	national sport
国体	kokutai	national polity
国道	kokudoo	national highway
国益	kokueki	national interest
国有	kokuyuu	national ownership
国宝	kokuhoo	national treasure
国々	kuniguni	countries
国旗	kokki	national flag
国税	kokuzei	national tax
国歌	kokka	national anthem
国策	kokusaku	national policy
国名	kokumei	country name
国力	kokuryoku	national power
国論	kokuron	public opinion
国賓	kokuhin	state guest
国威	kokui	national prestige
国是	kokuze	national policy
国母	kokubo	empress
国柄	kunigara	national character
国権	kokken	power of the state
国人	kunibito	indigenous person
国葬	kokusoo	state funeral
国事	kokuzi	national affairs
国定	kokutei	state-sponsored
国史	kokusi	history of a nation
国教	kokkyoo	state religion
国難	kokunan	national crisis
国津	kunitu	of the land
国大	kokudai	national university
国書	kokusyo	credentials
国賊	kokuzoku	traitor
国富	kokuhu	national wealth
国文	kokubun	national literature
国号	kokugoo	name of a country
国光	kokkoo	national glory
国辱	kokuzyoku	national disgrace
国勢	kokusei	of a country
国鳥	kokutyoo	national bird
国元	kunimoto	hometown
国司	kokusi	provincial governor
国花	kokka	national flower
国電	kokuden	national railroad
国主	kokusyu	king
国守	kokusyu	daimyo
国法	kokuhoo	national law
国禁	kokkin	state prohibition
国璽	kokuzi	the seal of state
国手	kokusyu	skilled physician
国利	kokuri	national interests
国華	kokka	national pride
国訛	kuninamari	dialect
国界	kokkai	national border
国許	kunimoto	hometown
国侍	kunizamurai	provincial samurai
国典	kokuten	national law
国表	kuniomote	one's home
全国	zenkoku	countrywide
外国	gaikoku	foreign country
各国	kakkoku	each nation
両国	ryookoku	both countries
諸国	syokoku	various countries
同国	dookoku	the same country
大国	taikoku	large country
入国	nyuukoku	entry to a country
自国	zikoku	one's own country
他国	takoku	foreign country
帝国	teikoku	empire
祖国	sokoku	motherland
王国	ookoku	kingdom
母国	bokoku	one's homeland
隣国	ringoku	neighbouring country
天国	tengoku	paradise
愛国	aikoku	country
建国	kenkoku	founding of a nation
戦国	sengoku	belligerent country
一国	ikkoku	whole country
立国	rikkoku	founding of a nation
東国	toogoku	eastern country
本国	hongoku	one's own country
軍国	gunkoku	nation at war
異国	ikoku	foreign country
小国	syookoku	small country
島国	simaguni	island country
雪国	yukiguni	snow country
北国	kitaguni	northern provinces
開国	kaikoku	founding a country
敵国	tekkoku	enemy nation
鎖国	sakoku	national isolation
南国	nangoku	southern countries
強国	kyookoku	strong nation
故国	kokoku	one's native land
富国	hukoku	rich country
万国	bankoku	all countries
亡国	bookoku	ruined country
内国	naikoku	home country
憂国	yuukoku	patriotism
皇国	kookoku	Japan
貴国	kikoku	your country
某国	bookoku	certain country
公国	kookoku	dukedom
属国	zokkoku	vassal state
神国	sinkoku	land of the gods
報国	hookoku	patriotism
山国	yamaguni	mountainous country
経国	keikoku	government
領国	ryoogoku	territory
和国	wakoku	Yamato
生国	syoogoku	one's native country
列国	rekkoku	nations
挙国	kyokoku	the whole nation
与国	yokoku	ally
遠国	ongoku	distant land
我国	wagakuni	our country
三国	sangoku	three countries
君国	kunkoku	monarchy
傾国	keikoku	beauty
御国	mikuni	country
治国	tikoku	government
弱国	zyakkoku	weak country
海国	kaikoku	maritime nation
郷国	kyookoku	one's native land
近国	kingoku	neighboring country
今年	kotosi	this year
今回	konkai	now
今後	kongo	from now on
今月	kongetu	this month
今季	konki	this season
今週	konsyuu	this week
今日	kyoo	today
今度	kondo	now
今春	konsyun	this spring
今夏	konka	this summer
今秋	konsyuu	autumn
今夜	konya	this evening
今期	konki	the present term
今朝	kesa	this morning
今期	konki	the present term
今冬	kontoo	this winter
今晩	konban	tonight
今時	imadoki	present day
今昔	konzyaku	past and present
今風	imahuu	modern style
今夕	konyuu	this evening
今様	imayoo	modern style
今宵	koyoi	this evening
今生	konzyoo	this life
今般	konpan	now
今頃	imagoro	about this time
今次	konzi	the present time
今上	kinzyoo	the reigning emperor
今暁	kongyoo	this morning
昨今	sakkon	nowadays
現今	genkon	the present
只今	tadaima	Here I am
即今	sokkon	at the moment
当今	tookon	nowadays
自今	zikon	from now on
方今	hookon	present time
唯今	tadaima	Here I am
左右	sayuu	left and right
左翼	sayoku	left-wing
左腕	sawan	left arm
左足	hidariasi	left foot
左派	saha	left wing
左手	hidarite	left hand
左上	hidariue	left-upper
左側	hidarigawa	left
左下	hidarisita	lower left
左辺	sahen	left side
左端	hidarihasi	left end
左肩	hidarikata	left shoulder
左目	hidarime	left eye
左記	saki	undermentioned
左折	sasetu	turning to the left
左隅	hidarisumi	left-hand corner
左官	sakan	plasterer
左遷	sasen	demotion
左舷	sagen	port
左脳	sanoo	left brain
左岸	sagan	left bank
左傾	sakei	leftist
左党	satoo	drinker
左巻	hidarimaki	counterclockwise
左様	sayoo	like that
右左	migihidari	right and left
極左	kyokusa	extreme left
証左	syoosa	evidence
三振	sansin	strike out
三塁	sanrui	third base
三男	sannan	three sons
三角	sankaku	triangle
三方	sanpoo	three sides
三月	sangatu	March
三女	sanzyo	third daughter
三昧	zanmai	indulgence
三種	sansyu	three kinds
三者	sansya	three persons
三唱	sansyoo	three cheers
三役	sanyaku	three highest ranks
三輪	sanrin	three wheels
三脚	sankyaku	tripod
三叉	mitumata	three-pronged fork
三猿	sanen	three wise monkeys
三流	sanryuu	third-rate
三軍	sangun	great army
三一	sanpin	low-ranking samurai
三国	sangoku	three countries
三葉	mituba	mitsuba
三面	sanmen	three sides
三下	sansita	petty underling
三思	sansi	deep reflection
三綱	sankoo	three bonds
三舎	sansya	three days' march
三椏	mitumata	Oriental paper bush
二三	nisan	two or three
両三	ryoosan	two or three
再三	saisan	again and again
元三	ganzan	New Year's period
山中	santyuu	in the mountains
山岳	sangaku	mountains
山頂	santyoo	summit
山間	sankan	among the mountains
山積	sanseki	lying in piles
山林	sanrin	mountain forest
山形	yamagata	mountain-shape
山村	sanson	mountain village
山脈	sanmyaku	mountain range
山々	yamayama	mountains
山荘	sansoo	mountain villa
山道	sandoo	mountain road
山菜	sansai	edible wild plants
山水	sansui	mountain and water
山地	santi	mountainous district
山場	yamaba	climax
山野	sanya	hills and fields
山里	yamazato	mountain hamlet
山系	sankei	mountain range
山車	dasi	festival car
山腹	sanpuku	hillside
山肌	yamahada	mountain's surface
山川	yamakawa	mountains and rivers
山麓	sanroku	foot of a mountain
山河	sanga	mountains and rivers
山内	sannai	in the mountains
山海	sankai	mountains and seas
山桜	yamazakura	mountain cherry
山路	yamazi	mountain path
山上	sanzyoo	mountain top
山椒	sansyoo	Japanese pepper
山伏	yamabusi	mountain priest
山吹	yamabuki	kerria
山門	sanmon	main temple gate
山寺	yamadera	mountain temple
山元	yamamoto	owner of a mountain
山姥	yamauba	mountain witch
山側	yamagawa	mountain-side
山羊	yagi	goat
山辺	yamabe	mountain
山芋	yamaimo	Japanese yam
山賊	sanzoku	bandit
山男	yamaotoko	giant
山猫	yamaneko	wildcat
山峡	yamakai	gorge
山行	sankoo	mountain hiking
山人	sanzin	mountain folk
山陵	sanryoo	mountains and hills
山国	yamaguni	mountainous country
山彦	yamabiko	echo
山家	yamaga	mountain villa
山際	yamagiwa	mountain ridge
山塊	sankai	mountain mass
山猿	yamazaru	monkey
山懐	yamahutokoro	heart of a mountain
山鳥	yamadori	copper pheasant
山嵐	yamaarasi	porcupine
山師	yamasi	speculator
山風	yamakaze	mountain wind
山稜	sanryoo	mountain ridge
山嶺	sanrei	mountaintop
山葵	wasabi	wasabi
山山	yamayama	mountains
山盛	yamamori	heap
山刀	yamagatana	woodman's hatchet
山砦	sansai	mountain stronghold
山岨	yamasowa	mountain cliff
山立	yamadati	bandit
山襞	yamahida	folds of a mountain
山桃	yamamomo	wax myrtle
山砲	sanpoo	mountain gun
山勘	yamakan	guesswork
山犬	yamainu	Japanese wolf
山塞	sansai	mountain stronghold
山気	yamaki	speculative spirit
山巓	santen	mountaintop
登山	tozan	mountain climbing
火山	kazan	volcano
鉱山	koozan	mine
下山	gezan	descending
小山	koyama	hill
銅山	doozan	copper mine
本山	honzan	head temple
氷山	hyoozan	iceberg
開山	kaisan	founding a temple
高山	koozan	high mountain
遠山	tooyama	distant mountain
野山	noyama	hills and fields
銀山	ginzan	silver mine
雪山	yukiyama	snowy mountains
青山	aoyama	lush mountain
床山	tokoyama	hairdresser
名山	meizan	famous mountain
奥山	okuyama	remote mountain
金山	kanayama	mine
岩山	iwayama	rocky mountain
石山	isiyama	stony mountain
冬山	huyuyama	wintry mountain
夏山	natuyama	summery mountain
治山	tisan	forest conservation
沢山	takusan	many
連山	renzan	mountain range
霊山	reizan	sacred mountain
遊山	yusan	excursion
泰山	taizan	large mountain
築山	tukiyama	artificial hill
後山	atoyama	pusher
黒山	kuroyama	large crowd
一山	hitoyama	one mountain
剣山	kenzan	needle-point holder
深山	miyama	mountain recess
外山	toyama	nearby mountain
砂山	sunayama	sand hill
島山	simayama	island mountain
黒山	kuroyama	large crowd
前山	sakiyama	skilled miner
当山	toozan	this mountain
鉄山	tetuzan	iron mine
山山	yamayama	mountains
先山	sakiyama	skilled miner
針山	hariyama	pincushion
端山	hayama	foothill
禿山	hageyama	bald mountain
仰山	gyoosan	large quantity
故山	kozan	one's native place
満山	manzan	the whole mountain
人山	hitoyama	crowd of people
廃山	haizan	abandoned mine
子供	kodomo	child
子宮	sikyuu	womb
子孫	sison	descendants
子守	komori	babysitter
子犬	koinu	puppy
子規	hototogisu	lesser cuckoo
子猫	koneko	kitten
子弟	sitei	people
子息	sisoku	son
子分	kobun	henchman
子羊	kohituzi	lamb
子女	sizyo	sons and daughters
子細	sisai	reasons
子音	siin	consonant
子爵	sisyaku	viscount
子葉	siyoo	cotyledon
子株	kokabu	new bulb
子癇	sikan	eclampsia
子鹿	kozika	fawn
子種	kodane	children
子持	komoti	parenthood
子房	siboo	ovary
子守	komori	babysitter
女子	zyosi	woman
男子	dansi	youth
息子	musuko	son
電子	densi	electron
様子	yoosu	state
親子	oyako	parent and child
調子	tyoosi	tune
原子	gensi	atom
母子	bosi	mother and child
弟子	desi	pupil
王子	oozi	prince
骨子	kossi	main point
帽子	boosi	hat
少子	syoosi	low birth rate
椅子	isu	chair
菓子	kasi	pastry
双子	hutago	twins
卵子	ransi	ovum
分子	bunsi	numerator
粒子	ryuusi	particle
冊子	sassi	book
精子	seisi	sperm
利子	risi	interest
養子	yoosi	adopted child
父子	husi	father and child
種子	syusi	seed
妻子	saisi	wife and children
因子	insi	factor
陽子	yoosi	proton
団子	dango	dango
里子	satogo	foster child
二子	hutago	twins
格子	koosi	lattice
獅子	sisi	lion
餃子	gyooza	pot sticker
扇子	sensu	folding fan
太子	taisi	Crown Prince
迷子	maigo	lost child
銚子	tyoosi	decanter
障子	syoozi	shoji
金子	kinsu	money
一子	issi	a child
素子	sosi	element
拍子	hyoosi	time
実子	zissi	biological child
愛子	itosigo	beloved child
童子	doozi	boy
光子	koosi	photon
幼子	osanago	infant
君子	kunsi	man of virtue
端子	tansi	terminal
量子	ryoosi	quantum
胞子	hoosi	spore
長子	tyoosi	eldest child
皇子	oozi	imperial prince
白子	sirako	soft roe
氏子	uziko	shrine parishioner
囃子	hayasi	Japanese orchestra
茄子	nasubi	eggplant
硝子	garasu	glass
柚子	yuzu	yuzu
杏子	anzu	apricot
公子	koosi	young nobleman
砂子	sunago	sand
舞子	maiko	apprentice geisha
鳴子	naruko	clapper
赤子	akago	baby
孝子	koosi	filial child
玉子	tamago	hen egg
沙子	isago	sand
天子	tensi	the emperor
容子	yoosu	state
世子	seisi	heir
義子	gisi	adopted child
遊子	yuusi	wanderer
椰子	yasi	palm tree
日子	nissi	days
穴子	anago	garden eel
馬子	mago	packhorse driver
末子	massi	youngest child
切子	kiriko	facet
繻子	syusu	satin
辛子	karasi	mustard
踊子	odoriko	dancer
判子	hanko	seal
梯子	hasigo	ladder
杓子	syakusi	bamboo ladle
店子	tanako	tenant
勢子	seko	beater
嫡子	tyakusi	legitimate child
御子	miko	God's son
逆子	sakago	breech presentation
中子	nakago	core
草子	soosi	written work
附子	husi	sumac gallnut
楊子	yoozi	toothpick
継子	mamako	stepchild
撫子	nadesiko	pink
呼子	yobiko	whistle
芥子	karasi	mustard
嗣子	sisi	heir
猪子	inoko	wild boar
羽子	hago	shuttlecock
筋子	suziko	salted salmon roe
才子	saisi	talented man
市子	itiko	sorceress
庶子	syosi	illegitimate child
張子	hariko	papier mache
碍子	gaisi	insulator
諸子	syosi	gentlemen
眸子	boosi	eye
次子	zisi	the next child
丁子	tyoozi	clove
板子	itago	ship plank
桑子	kuwago	silkworm
綸子	rinzu	figured satin
芸子	geiko	geisha
神子	miko	shrine maiden
緞子	donsu	silk damask
瞳子	doosi	pupil
捨子	sutego	abandoned child
振子	huriko	pendulum
組子	kumiko	member
瓶子	heizi	earthenware pot
付子	husi	sumac gallnut
梃子	teko	lever
骰子	saikoro	dice
遺子	isi	orphan
紙子	kamiko	paper garment
売子	uriko	salesperson
螺子	nezi	screw
刺子	sasiko	quilting
針子	hariko	seamstress
台子	daisu	large utensil stand
猶子	yuusi	nephew
簀子	sunoko	drainboard
四球	sikyuu	four balls
四季	siki	four seasons
四方	sihoo	every direction
四輪	yonrin	four-wheeled
四月	sigatu	April
四肢	sisi	limbs
四隅	yosumi	four corners
四大	sidai	the four elements
四角	sikaku	square
四書	sisyo	the Four Books
四則	sisoku	rules of arithmetic
四散	sisan	scattering
四囲	sii	surroundings
四海	sikai	the whole world
四阿	azumaya	arbor
四辺	sihen	four-sided
四面	simen	four sides
四声	sisei	four tones
四辻	yotutuzi	crossroads
四隣	sirin	whole neighborhood
時間	zikan	time
時代	zidai	period
時半	zihan	about an hour
時点	ziten	point in time
時計	tokei	watch
時刻	zikoku	instant
時価	zika	current value
時速	zisoku	speed
時事	zizi	events of the day
時限	zigen	period
時給	zikyuu	hourly pay
時差	zisa	time difference
時々	tokidoki	sometimes
時空	zikuu	space-time
時流	ziryuu	of the times
時報	zihoo	announcement of time
時機	ziki	opportunity
時宗	zisyuu	Jishu sect
時雨	sigure	drizzle
時宜	zigi	right time
時短	zitan	shortening of time
時限	zigen	period
時分	zibun	time
時勢	zisei	spirit of the age
時数	zisuu	number of hours
時局	zikyoku	situation
時世	zisei	the times
時節	zisetu	season
時分	zibun	time
時候	zikoo	season
時季	ziki	season
時鳥	hototogisu	lesser cuckoo
時制	zisei	tense
時下	zika	nowadays
時日	zizitu	date
時化	sike	stormy weather
時運	ziun	tide of the times
時人	zizin	contemporaries
時針	zisin	hour hand
時文	zibun	modern literature
時時	tokidoki	sometimes
当時	toozi	at that time
一時	itizi	one o'clock
同時	doozi	simultaneous
適時	tekizi	timely
臨時	rinzi	temporary
即時	sokuzi	prompt
戦時	senzi	war time
日時	nitizi	date and time
常時	zyoozi	usually
定時	teizi	regular time
瞬時	syunzi	moment
平時	heizi	normal times
往時	oozi	ancient times
今時	imadoki	present day
潮時	siodoki	tidal hour
幼時	yoozi	childhood
計時	keizi	clocking
片時	katatoki	moment
何時	itu	when
金時	kintoki	red
盛時	seizi	prime of life
不時	huzi	emergency
近時	kinzi	recently
暫時	zanzi	short while
毎時	maizi	every hour
花時	hanadoki	flowering season
半時	hantoki	little while
適時	tekizi	timely
旧時	kyuuzi	ancient times
時時	tokidoki	sometimes
昔時	sekizi	old times
七生	sitisyoo	seven lives
七月	sitigatu	July
七宝	sippoo	the 7 treasures
七曜	sitiyoo	the seven luminaries
七重	nanae	sevenfold
車両	syaryoo	rolling stock
車種	syasyu	car make
車線	syasen	traffic lane
車体	syatai	body
車輪	syarin	wheel
車掌	syasyoo	conductor
車庫	syako	garage
車検	syaken	vehicle inspection
車道	syadoo	roadway
車窓	syasoo	train window
車軸	syaziku	axle
車外	syagai	outside a car
車載	syasai	in-vehicle
車台	syadai	chassis
車座	kurumaza	sitting in a circle
車代	kurumadai	carfare
車輛	syaryoo	rolling stock
車券	syaken	ticket
車夫	syahu	rickshaw man
車力	syariki	cartman
車馬	syaba	horses and vehicles
車速	syasoku	vehicle speed
車輌	syaryoo	rolling stock
車寄	kurumayose	carriage porch
電車	densya	train
駐車	tyuusya	parking
列車	ressya	train
飛車	hisya	castle
新車	sinsya	new car
下車	gesya	alighting
拍車	hakusya	spur
戦車	sensya	tank
停車	teisya	stopping
歯車	haguruma	gear
汽車	kisya	train
風車	kazaguruma	pinwheel
馬車	basya	coach
台車	daisya	platform truck
愛車	aisya	beloved car
外車	gaisya	foreign automobile
山車	dasi	festival car
水車	mizuguruma	water wheel
降車	koosya	alighting
洗車	sensya	car wash
客車	kyakusya	passenger car
貨車	kasya	freight car
操車	soosya	operation
荷車	niguruma	cart
滑車	kassya	pulley
実車	zissya	occupied taxi
牛車	gissya	ox carriage
横車	yokoguruma	perverseness
香車	kyoosya	spear
単車	tansya	motorcycle
満車	mansya	full parking lot
空車	kuusya	empty conveyance
口車	kutiguruma	cajolery
前車	zensya	the car ahead
糸車	itoguruma	spinning wheel
戸車	toguruma	sash roller
猫車	nekoguruma	wheelbarrow
矢車	yaguruma	arrow wheel
花車	kyasya	dainty
砲車	hoosya	gun carriage
柩車	kyuusya	hearse
手車	teguruma	handcart
十分	zyuubun	plenty
十月	zyuugatu	October
十字	zyuuzi	cross
十全	zyuuzen	perfection
十戒	zikkai	the 10 precepts
十指	zissi	the ten fingers
十方	zippoo	the ten directions
十目	zyuumoku	all eyes
十薬	zyuuyaku	chameleon plant
十善	zyuuzen	the ten good acts
出場	syutuzyoo	appearance
出身	syussin	person's origin
出席	syusseki	attendance
出版	syuppan	publication
出演	syutuen	performance
出資	syussi	investment
出馬	syutuba	running
出発	syuppatu	departure
出産	syussan	childbirth
出荷	syukka	shipping
出品	syuppin	exhibit
出火	syukka	outbreak of fire
出動	syutudoo	sailing
出生	syussyoo	birth
出走	syussoo	entry in a race
出張	syuttyoo	official tour
出現	syutugen	appearance
出血	syukketu	bleeding
出口	deguti	exit
出勤	syukkin	attendance
出番	deban	one's turn
出来	deki	workmanship
出頭	syuttoo	appearance
出塁	syuturui	on base
出力	syuturyoku	output
出所	syussyo	birthplace
出向	syukkoo	being transferred
出世	syusse	success in life
出題	syutudai	setting a question
出港	syukkoo	departure
出願	syutugan	application
出廷	syuttei	appearance in court
出方	dekata	attitude
出展	syutten	exhibit
出足	deasi	start
出先	desaki	one's destination
出費	syuppi	expenses
出没	syutubotu	appearing frequently
出金	syukkin	withdrawal
出前	demae	catering
出水	syussui	flood
出航	syukkoo	departure
出撃	syutugeki	sortie
出自	syutuzi	birthplace
出社	syussya	going to work
出征	syussei	going to war
出船	syussen	weighing anchor
出兵	syuppei	dispatch of troops
出色	syussyoku	prominence
出処	syussyo	birthplace
出典	syutten	source
出漁	syuturyoo	going fishing
出稿	syukkoo	placing
出欠	syukketu	presence or absence
出窓	demado	bay window
出獄	syutugoku	release
出立	syuttatu	departure
出奔	syuppon	flight
出仕	syussi	attendance
出射	syussya	output
出目	deme	protruding eyes
出汁	dasi	dashi
出刃	deba	knife
出陳	syuttin	to an exhibition
出帆	syuppan	sailing
出会	deai	meeting
出炭	syuttan	coal production
出合	deai	meeting
出超	syuttyoo	excess of exports
出札	syussatu	issuing tickets
出物	demono	rash
出御	syutugyo	emperor's arrival
出芽	syutuga	germination
出師	suisi	dispatch of troops
出端	deha	chance of going out
出花	debana	first brew of tea
出格	syukkaku	elative
出湯	ideyu	hot spring
出鼻	debana	projecting part
出府	syuppu	going to the capital
出捐	syutuen	contribution
提出	teisyutu	to present
進出	sinsyutu	advance
輸出	yusyutu	export
演出	ensyutu	production
排出	haisyutu	evacuation
選出	sensyutu	election
支出	sisyutu	expenditure
流出	ryuusyutu	discharge
検出	kensyutu	detection
歳出	saisyutu	annual expenditure
脱出	dassyutu	escape
救出	kyuusyutu	rescue
外出	gaisyutu	outing
抽出	tyuusyutu	extraction
拠出	kyosyutu	donation
噴出	hunsyutu	spewing
創出	soosyutu	creation
放出	hoosyutu	release
算出	sansyutu	calculation
摘出	tekisyutu	picking out
貸出	kasidasi	lending
突出	tossyutu	projection
露出	rosyutu	exposure
転出	tensyutu	moving out
搬出	hansyutu	carry out
船出	hunade	setting sail
捻出	nensyutu	contriving
人出	hitode	crowd
産出	sansyutu	yield
嫡出	tyakusyutu	legitimate birth
傑出	kessyutu	excel
退出	taisyutu	leaving
表出	hyoosyutu	expression
総出	soode	all together
遠出	toode	going afar
供出	kyoosyutu	delivery
漏出	roosyutu	leaking out
日出	nissyutu	sunrise
溶出	yoosyutu	liquation
現出	gensyutu	appearance
作出	sakusyutu	new creation
初出	syosyutu	first appearance
届出	todokede	report
頻出	hinsyutu	common
派出	hasyutu	sending out
送出	soosyutu	sending
湧出	yuusyutu	gushing out
発出	hassyutu	issue
描出	byoosyutu	description
滲出	sinsyutu	infiltration
案出	ansyutu	contrivance
訳出	yakusyutu	translation
抄出	syoosyutu	taking excerpts
浸出	sinsyutu	infiltration
析出	sekisyutu	separating
死出	side	death
呼出	yobidasi	call
振出	huridasi	starting point
射出	syasyutu	shooting
遅出	osode	late attendance
移出	isyutu	export
売出	uridasi	sale
特出	tokusyutu	prominence
重出	zyuusyutu	citing again
帯出	taisyutu	taking out
投出	toosyutu	projection
導出	doosyutu	derivation
奔出	honsyutu	gushing out
正出	seisyutu	legitimate child
他出	tasyutu	going out
書記	syoki	clerk
書類	syorui	documents
書店	syoten	bookshop
書道	syodoo	calligraphy
書籍	syoseki	book
書簡	syokan	letter
書房	syoboo	library
書評	syohyoo	book review
書面	syomen	document
書家	syoka	calligrapher
書物	syomotu	books
書留	kakitome	registered mail
書斎	syosai	study
書院	syoin	drawing room
書名	syomei	book title
書体	syotai	calligraphic style
書法	syohoo	penmanship
書写	syosya	transcription
書棚	syodana	bookshelf
書庫	syoko	archive
書肆	syosi	bookstore
書状	syozyoo	letter
書式	syosiki	blank form
書誌	syosi	bibliography
書林	syorin	vast stock of books
書架	syoka	bookshelf
書跡	syoseki	writing
書信	syosin	letter
書証	syosyoo	documentary evidence
書見	syoken	reading
書目	syomoku	catalogue of books
書痙	syokei	writer's cramp
書翰	syokan	letter
文書	bunsyo	document
秘書	hisyo	secretary
著書	tyosyo	literary work
読書	dokusyo	reading
白書	hakusyo	white paper
本書	honsyo	text
新書	sinsyo	new book
図書	tosyo	books
調書	tyoosyo	protocol
肩書	katagaki	title
辞書	zisyo	dictionary
投書	toosyo	letter to the editor
証書	syoosyo	bond
教書	kyoosyo	message
覚書	oboegaki	memo
聖書	seisyo	Bible
字書	zisyo	dictionary
古書	kosyo	old book
信書	sinsyo	letter
同書	doosyo	the same book
封書	huusyo	sealed letter
蔵書	zoosyo	book collection
司書	sisyo	librarian
臨書	rinsyo	writing
選書	sensyo	anthology
訳書	yakusyo	translation
詔書	syoosyo	imperial edict
洋書	yoosyo	Western books
落書	rakugaki	scrawl
隷書	reisyo	clerical script
原書	gensyo	original document
念書	nensyo	written pledge
叢書	soosyo	series
行書	gyoosyo	running script
草書	soosyo	cursive script
国書	kokusyo	credentials
墨書	bokusyo	writing in India ink
良書	ryoosyo	good book
裏書	uragaki	endorsement
史書	sisyo	history book
清書	seisyo	clean copy
葉書	hagaki	postcard
青書	seisyo	Blue Book
自書	zisyo	one's own writing
偽書	gisyo	spurious letter
類書	ruisyo	similar books
和書	wasyo	book in Japanese
代書	daisyo	amanuensis
詩書	sisyo	book of poetry
返書	hensyo	reply
愛書	aisyo	great love of books
奇書	kisyo	unusual book
全書	zensyo	complete book
漢書	kansyo	Chinese book
四書	sisyo	the Four Books
双書	soosyo	series
焚書	hunsyo	book burning
密書	missyo	secret message
雁書	gansyo	letter
歌書	kasyo	book of poems
奥書	okugaki	postscript
悪書	akusyo	harmful book
医書	isyo	medical book
後書	atogaki	afterword
浄書	zyoosyo	clean copy
手書	syusyo	writing by oneself
前書	zensyo	previous writing
勅書	tyokusyo	imperial rescript
朱書	syusyo	writing in red
筋書	suzigaki	synopsis
血書	kessyo	writing in blood
表書	omotegaki	address
仏書	bussyo	Buddhist scriptures
稀書	kisyo	rare book
珍書	tinsyo	rare book
頭書	toosyo	headnote
抜書	nukigaki	extract
品書	sinagaki	catalog
希書	kisyo	rare book
謹書	kinsyo	respectfully written
雑書	zassyo	assorted books
真書	sinsyo	square style
俗書	zokusyo	cheap fiction
来書	raisyo	letter received
女性	zyosei	woman
女子	zyosi	woman
女優	zyoyuu	actress
女児	zyozi	baby girl
女王	zyooo	queen
女流	zyoryuu	woman
女房	nyooboo	wife
女神	megami	goddess
女系	zyokei	female line
女将	okami	mistress
女医	zyoi	woman doctor
女装	zyosoo	female clothing
女人	nyonin	women
女心	onnagokoro	woman's heart
女中	zyotyuu	maid
女手	onnade	female labor
女官	nyokan	court lady
女史	zyosi	Ms
女体	nyotai	woman's body
女声	zyosei	female voice
女傑	zyoketu	brave woman
女郎	zyoroo	prostitute
女婿	zyosei	one's son-in-law
女御	nyogo	court lady
女物	onnamono	women's goods
女給	zyokyuu	waitress
女囚	zyosyuu	female prisoner
女権	zyoken	women's rights
女難	zyonan	trouble with women
女癖	onnaguse	philandering
女竹	medake	Simon bamboo
女気	onnake	female presence
男女	danzyo	men and women
彼女	kanozyo	she
少女	syoozyo	little girl
長女	tyoozyo	eldest daughter
次女	zizyo	second daughter
美女	bizyo	beautiful woman
魔女	mazyo	witch
婦女	huzyo	woman
乙女	otome	little girl
京女	kyooonna	Kyoto woman
王女	oozyo	princess
幼女	yoozyo	little girl
遊女	yuuzyo	prostitute
三女	sanzyo	third daughter
老女	roozyo	elderly woman
養女	yoozyo	adopted daughter
処女	syozyo	virgin
悪女	akuzyo	wicked or ugly woman
天女	tennyo	heavenly nymph
海女	ama	ama
巫女	huzyo	shrine maiden
淑女	syukuzyo	lady
皇女	oozyo	imperial princess
侍女	zizyo	lady attendant
子女	sizyo	sons and daughters
童女	doozyo	girl
聖女	seizyo	saint
雪女	yukionna	snow woman
貴女	kizyo	noblewoman
才女	saizyo	talented woman
鬼女	kizyo	demoness
仙女	sennyo	fairy
織女	syokuzyo	female weaver
下女	gezyo	maid servant
郎女	iratume	lass
一女	itizyo	daughter
息女	sokuzyo	daughter
采女	uneme	maid-in-waiting
醜女	syuuzyo	homely woman
官女	kanzyo	court lady
妻女	saizyo	one's wife
貞女	teizyo	virtuous woman
妓女	gizyo	woman entertainer
小女	koonna	small woman
信女	sinnyo	female lay devotee
妖女	yoozyo	enchantress
烈女	retuzyo	heroine
狂女	kyoozyo	madwoman
孝女	koozyo	filial daughter
善女	zennyo	female believer
石女	umazume	woman
売女	baita	prostitute
小説	syoosetu	novel
小型	kogata	small size
小学	syoogaku	elementary school
小売	kouri	retail
小児	syooni	young child
小屋	koya	hut
小幅	kohaba	small
小麦	komugi	wheat
小柄	kogara	small build
小山	koyama	hill
小差	syoosa	slight difference
小銃	syoozyuu	rifle
小川	ogawa	streamlet
小国	syookoku	small country
小松	komatu	small pine
小物	komono	accessories
小口	koguti	cut end
小委	syooi	subcommittee
小品	syoohin	something very small
小手	kote	forearm
小包	kozutumi	parcel
小鳥	kotori	small bird
小指	koyubi	little finger
小雨	kosame	light rain
小石	koisi	pebble
小僧	kozoo	youngster
小町	komati	a belle
小粒	kotubu	small grain
小腸	syootyoo	small intestine
小銭	kozeni	coins
小声	kogoe	low voice
小島	kozima	small island
小雪	koyuki	light snow
小豆	azuki	adzuki beans
小人	kodomo	child
小便	syooben	urine
小康	syookoo	lull
小言	kogoto	scolding
小舟	kobune	boat
小目	komoku	komoku
小兵	kohyoo	small build
小道	komiti	path
小判	koban	koban
小路	koozi	lane
小脳	syoonoo	cerebellum
小袖	kosode	short sleeves
小生	syoosei	I
小唄	kouta	ballad
小金	kogane	small sum of money
小鉢	kobati	small bowl
小心	syoosin	timidity
小皿	kozara	small dish
小話	kobanasi	anecdote
小作	kosaku	tenant farming
小鼓	kotuzumi	small hand drum
小瓶	kobin	small bottle
小粋	koiki	stylish
小骨	kobone	small bones
小紋	komon	fine pattern
小姓	kosyoo	page
小刀	kogatana	small knife
小米	kogome	crushed rice
小異	syooi	minor differences
小袋	kobukuro	small bag
小隊	syootai	platoon
小径	syookei	path
小食	syoosyoku	light eating
小数	syoosuu	fraction
小首	kokubi	head
小犬	koinu	puppy
小額	syoogaku	small sum
小節	syoosetu	bar
小事	syoozi	trifling matter
小腹	kobara	belly
小用	syooyoo	trifling matter
小船	kobune	boat
小心	syoosin	timidity
小曲	syookyoku	short piece of music
小耳	komimi	overhear
小雀	kogara	willow tit
小脇	kowaki	under one's arm
小計	syookei	subtotal
小姑	kozyuutome	sister-in-law
小波	sazanami	ripple
小鼻	kobana	nostrils
小片	syoohen	crumbling
小菊	kogiku	small chrysanthemum
小咄	kobanasi	anecdote
小社	syoosya	company
小伝	syooden	biographical sketch
小娘	komusume	young girl
小形	kogata	small size
小夜	sayo	evening
小水	syoosui	urine
小火	boya	small fire
小間	koma	small room
小粋	koiki	stylish
小男	kootoko	small man
小槌	kozuti	mallet
小味	koazi	delicate flavor
小宴	syooen	party
小遣	kozukai	pocket money
小成	syoosei	a minor success
小農	syoonoo	small farmer
小名	syoomyoo	minor feudal lord
小引	syooin	short preface
小者	komono	young person
小破	syooha	slight damage
小欲	syooyoku	slightly covetous
小篆	syooten	small seal script
小器	syooki	small container
小女	koonna	small woman
小使	kozukai	janitor
小乗	syoozyoo	Hinayana
小身	syoosin	humble position
小潮	kosio	neap tide
小勇	syooyuu	brute courage
小鴨	kogamo	green-winged teal
小才	kosai	cleverness
小冊	syoosatu	pamphlet
小店	syooten	little shop
小童	kowappa	boy
小編	syoohen	conte
小皺	koziwa	fine wrinkles
小我	syooga	the self
小官	syookan	petty official
小股	komata	short steps
小糠	konuka	rice bran
小策	syoosaku	petty trick
小勢	kozei	a small force
小善	syoozen	a small kindness
小昼	kohiru	just before noon
小癪	kosyaku	impudent
中小	tyuusyoo	small to medium
縮小	syukusyoo	reduction
最小	saisyoo	smallest
大小	daisyoo	sizes
過小	kasyoo	too small
弱小	zyakusyoo	puniness
微小	bisyoo	microscopic
微小	bisyoo	microscopic
極小	kyokusyoo	minimum
矮小	waisyoo	diminutive
極小	kyokusyoo	minimum
狭小	kyoosyoo	narrow
短小	tansyoo	short and small
卑小	hisyoo	petty
過小	kasyoo	too small
狭小	kyoosyoo	narrow
細小	saisyoo	minute
群小	gunsyoo	trifling
上昇	zyoosyoo	rising
上位	zyooi	superior
上場	zyoozyoo	listing
上限	zyoogen	upper limit
上演	zyooen	performance
上手	zyoozu	skill
上映	zyooei	screening
上下	zyooge	top and bottom
上司	zyoosi	superior authorities
上方	kamigata	Kyoto and vicinity
上空	zyookuu	sky
上陸	zyooriku	landing
上級	zyookyuu	advanced level
上部	zyoobu	top part
上辺	uwabe	seeming
上流	zyooryuu	upper stream
上申	zyoosin	report to a superior
上着	uwagi	coat
上々	zyoozyoo	the best
上層	zyoosoo	upper stratum
上質	zyoositu	fine quality
上席	zyooseki	seniority
上達	zyootatu	improvement
上品	zyoohin	elegant
上世	zyoosei	antiquity
上段	zyoodan	upper tier
上手	zyoozu	skill
上等	zyootoo	superiority
上程	zyootei	introducing
上体	zyootai	upper body
上記	zyooki	above-mentioned
上訴	zyooso	appeal
上官	zyookan	superior officer
上々	zyoozyoo	the best
上戸	zyoogo	heavy drinker
上座	kamiza	chief seat
上田	zyooden	high rice field
上人	syoonin	holy priest
上腕	zyoowan	upper arm
上気	zyooki	flushing
上値	uwane	higher price
上巻	zyookan	first volume
上背	uwazei	stature
上皮	zyoohi	epithelium
上水	zyoosui	water supply
上白	zyoohaku	first-class rice
上代	zyoodai	ancient times
上役	uwayaku	superior
上梓	zyoosi	publication
上意	zyooi	will or decree
上皇	zyookoo	retired emperor
上面	uwatura	surface
上家	uwaya	storage shed
上天	zyooten	heaven
上奏	zyoosoo	report to the throne
上端	zyootan	upper end
上物	zyoomono	quality goods
上屋	uwaya	shed
上客	zyookyaku	guest of honor
上側	uwagawa	upper side
上肢	zyoosi	upper limbs
上唇	uwakutibiru	upper lip
上使	zyoosi	shogun's envoy
上様	uesama	emperor
上絵	uwae	printed figures
上衣	uwagi	coat
上策	zyoosaku	excellent plan
上玉	zyoodama	fine jewel
上弦	zyoogen	1st quarter of moon
上薬	uwagusuri	glaze
上顎	zyoogaku	upper jaw
上靴	uwagutu	hallway slippers
上述	zyoozyutu	above-mentioned
上長	zyootyoo	one's superior
上臈	zyooroo	court lady
上製	zyoosei	superior make
上目	uwame	upward glance
上古	zyooko	ancient times
上底	agezoko	false bottom
上覧	zyooran	imperial inspection
上作	zyoosaku	good crop
上寿	zyoozyu	100th birthday
上帝	zyootei	Shangti
上紙	uwagami	paper cover
上乗	zyoozyoo	the best
上船	zyoosen	embarking
上塗	uwanuri	coat
上聞	zyoobun	an imperial hearing
上諭	zyooyu	imperial edict
以上	izyoo	not less than
陸上	rikuzyoo	land
史上	sizyoo	historical
売上	uriage	amount sold
向上	koozyoo	elevation
浮上	huzyoo	surfacing
海上	kaizyoo	sea
途上	tozyoo	en route
地上	tizyoo	above ground
路上	rozyoo	road
返上	henzyoo	give up
屋上	okuzyoo	rooftop
炎上	enzyoo	blazing up
北上	hokuzyoo	going north
左上	hidariue	left-upper
至上	sizyoo	supremacy
頂上	tyoozyoo	top
席上	sekizyoo	at the meeting
年上	tosiue	older
頭上	zuzyoo	overhead
紙上	sizyoo	on paper
洋上	yoozyoo	on the sea or ocean
右上	migiue	right-upper
水上	suizyoo	aquatic
身上	sinzyoo	merit
壇上	danzyoo	on a stage
献上	kenzyoo	presenting to
机上	kizyoo	on the desk
口上	koozyoo	vocal message
線上	senzyoo	on the line
床上	yukaue	on a floor
船上	senzyoo	on board
最上	saizyoo	best
卓上	takuzyoo	desktop
東上	toozyoo	going to Tokyo
真上	maue	just above
天上	tenzyoo	the heavens
堂上	doozyoo	on the roof
雪上	setuzyoo	on the snow
風上	kazakami	windward
誌上	sizyoo	in a magazine
同上	doozyoo	same as above
極上	gokuzyoo	first-rate
遡上	sozyoo	going upstream
艦上	kanzyoo	aboard a warship
山上	sanzyoo	mountain top
逆上	gyakuzyoo	frenzy
目上	meue	superior
最上	saizyoo	best
湖上	kozyoo	on the lake
父上	titiue	father
機上	kizyoo	aboard an aeroplane
階上	kaizyoo	an upper floor
砂上	sazyoo	on sand
参上	sanzyoo	calling on
母上	hahaue	mother
雲上	unzyoo	above the clouds
無上	muzyoo	best
世上	sezyoo	the world
股上	matagami	waist
途上	tozyoo	en route
市上	sizyoo	in the town
直上	tyokuzyoo	above
今上	kinzyoo	the reigning emperor
言上	gonzyoo	telling
進上	sinzyoo	giving
値上	neage	price hike
御上	okami	Emperor
仕上	siage	end
殿上	tenzyoo	the court
聖上	seizyoo	the emperor
史上	sizyoo	historical
主上	syuzyoo	emperor
如上	zyozyoo	above-mentioned
食品	syokuhin	commodity
食事	syokuzi	meal
食卓	syokutaku	dining table
食料	syokuryoo	food
食糧	syokuryoo	food
食材	syokuzai	ingredient
食肉	syokuniku	meat
食堂	syokudoo	dining room
食物	syokumotu	food
食用	syokuyoo	for use as food
食欲	syokuyoku	appetite
食器	syokki	tableware
食費	syokuhi	food expense
食道	syokudoo	esophagus
食後	syokugo	after a meal
食塩	syokuen	table salt
食味	syokumi	taste
食分	syokubun	phase of an eclipse
食酢	syokuzu	vinegar
食通	syokutuu	gourmandism
食前	syokuzen	before meals
食傷	syokusyoo	surfeit
食指	syokusi	forefinger
食前	syokuzen	before meals
食餌	syokuzi	dietary cure
食膳	syokuzen	dining table
食言	syokugen	eat one's words
食券	syokken	meal ticket
食間	syokkan	between meals
食客	syokkyaku	house guest
食紅	syokubeni	red food coloring
飲食	insyoku	food and drink
昼食	tyuusyoku	lunch
夕食	yuusyoku	evening meal
給食	kyuusyoku	provision of lunch
朝食	tyoosyoku	breakfast
会食	kaisyoku	dining together
外食	gaisyoku	eating out
和食	wasyoku	Japanese food
主食	syusyoku	staple food
洋食	yoosyoku	Western-style meal
腐食	husyoku	corrosion
日食	nissyoku	solar eclipse
試食	sisyoku	sampling food
断食	danziki	fasting
肉食	nikusyoku	meat eating
定食	teisyoku	set meal
過食	kasyoku	overeating
草食	soosyoku	herbivorous
飽食	hoosyoku	gluttony
侵食	sinsyoku	encroachment
浸食	sinsyoku	erosion
軽食	keisyoku	light meal
月食	gessyoku	lunar eclipse
寝食	sinsyoku	bed and food
生食	seisyoku	eating something raw
常食	zyoosyoku	daily food
捕食	hosyoku	predation
間食	kansyoku	eating between meals
夜食	yasyoku	supper
粗食	sosyoku	simple diet
餌食	eziki	prey
菜食	saisyoku	vegetable diet
中食	tyuuziki	lunch
偏食	hensyoku	unbalanced diet
衣食	isyoku	food and clothing
欠食	kessyoku	missing a meal
立食	rissyoku	stand-up meal
大食	taisyoku	gluttony
乞食	koziki	beggar
毎食	maisyoku	every meal
雑食	zassyoku	omnivorous
酒食	syusyoku	drink
絶食	zessyoku	fasting
暴食	boosyoku	overeating
小食	syoosyoku	light eating
副食	hukusyoku	side dish
糧食	ryoosyoku	provisions
海食	kaisyoku	marine erosion
少食	syoosyoku	light eating
減食	gensyoku	diet
粉食	hunsyoku	powdered food
風食	huusyoku	wind erosion
悪食	akuziki	eating poor food
蚕食	sansyoku	encroachment
貪食	donsyoku	voracity
節食	sessyoku	eating lightly
徒食	tosyoku	idle life
寄食	kisyoku	parasitism
穀食	kokusyoku	cereal diet
粒食	ryuusyoku	eating rice
水食	suisyoku	erosion
馬食	basyoku	heavy eating
晩食	bansyoku	supper
人間	ningen	human being
人気	ninki	popularity
人物	zinbutu	character
人々	hitobito	each person
人事	zinzi	personnel affairs
人生	zinsei	life
人口	zinkoo	population
人権	zinken	human rights
人材	zinzai	capable person
人工	zinkoo	artificial
人類	zinrui	mankind
人民	zinmin	people
人道	zindoo	humanity
人質	hitoziti	hostage
人数	ninzuu	the number of people
人形	ningyoo	doll
人員	zinin	number of persons
人種	zinsyu	race
人組	ningumi	~-man group
人選	zinsen	personnel selection
人格	zinkaku	personality
人前	ninmae	portion of food
人柄	hitogara	personality
人的	zinteki	human
人脈	zinmyaku	personal connections
人体	zintai	human body
人身	zinsin	the human body
人情	ninzyoo	humanity
人命	zinmei	life
人手	hitode	starfish
人為	zini	human work
人文	zinbun	humanity
人前	hitomae	the public
人出	hitode	crowd
人目	hitome	public gaze
人心	zinsin	human nature
人名	zinmei	person's name
人骨	zinkotu	human bones
人影	hitokage	figure of a person
人妻	hitozuma	married woman
人里	hitozato	human habitation
人災	zinsai	man-made calamity
人力	zinriki	human power
人魚	ningyo	mermaid
人望	zinboo	popularity
人家	zinka	house
人相	ninsoo	physiognomy
人様	hitosama	other people
人波	hitonami	surging crowd
人垣	hitogaki	crowd of people
人達	hitotati	people
人参	ninzin	carrot
人君	zinkun	sovereign
人造	zinzoo	man-made
人知	zinti	human intellect
人称	ninsyoo	person
人月	ningetu	man month
人馬	zinba	men and horses
人徳	nintoku	natural virtue
人肌	hitohada	the skin
人語	zingo	human speech
人足	hitoasi	pedestrian traffic
人後	zingo	behind others
人士	zinsi	well-bred man
人頭	zintoo	the number of people
人畜	zintiku	men and animals
人面	zinmen	human face
人倫	zinrin	human relations
人夫	ninpu	laborer
人人	hitobito	each person
人世	zinsei	this world
人柱	hitobasira	human pillar
人寿	zinzyu	man's life span
人伝	hitozute	hearsay
人中	hitonaka	society
人品	zinpin	personal appearance
人並	hitonami	being average
人別	ninbetu	census-taking
人魂	hitodama	disembodied soul
人声	hitogoe	human voice
人智	zinti	human intellect
人性	zinsei	human nature
人糞	zinpun	human excrement
人外	zingai	uninhabited area
人界	zinkai	world of man
人皇	zinnoo	emperor
人臣	zinsin	subjects
人傑	zinketu	great man
人山	hitoyama	crowd of people
人爵	zinsyaku	worldly honors
個人	kozin	individual
法人	hoozin	corporate body
殺人	satuzin	murder
名人	meizin	master
本人	honnin	the person himself
新人	sinzin	new face
大人	otona	adult
友人	yuuzin	friend
老人	roozin	the aged
知人	tizin	friend
犯人	hannin	offender
他人	tanin	another person
証人	syoonin	witness
夫人	huzin	wife
黒人	kokuzin	black person
成人	seizin	adult
詩人	sizin	poet
主人	syuzin	head
巨人	kyozin	giant
職人	syokunin	worker
軍人	gunzin	military personnel
恋人	koibito	lover
歌人	kazin	poet
婦人	huzin	woman
白人	hakuzin	white person
求人	kyuuzin	offer of job
邦人	hoozin	Japanese national
役人	yakunin	government official
俳人	haizin	haiku poet
故人	kozin	the deceased
無人	muzin	lack of help
美人	bizin	beautiful person
要人	yoozin	important person
真人	sinzin	true man
素人	sirooto	amateur
有人	yuuzin	manned
芸人	geinin	player
別人	betuzin	different person
住人	zyuunin	dweller
隣人	rinzin	neighbour
対人	taizin	personal
同人	doozin	literary group
達人	tatuzin	master
商人	syoonin	trader
愛人	aizin	lover
村人	murabito	villager
浪人	roonin	ronin
先人	senzin	predecessor
囚人	syuuzin	prisoner
楽人	gakuzin	musician
変人	henzin	eccentric
旅人	tabibito	traveller
当人	toonin	the one concerned
鉄人	tetuzin	iron man
病人	byoonin	sick person
悪人	akunin	bad person
原人	genzin	primitive man
公人	koozin	public character
盲人	moozin	blind person
無人	bunin	lack of help
文人	bunzin	person of letters
何人	nanibito	everyone
私人	sizin	private individual
賢人	kenzin	wise man
怪人	kaizin	mysterious person
家人	kazin	the family
番人	bannin	guard
聖人	seizin	saint
恩人	onzin	benefactor
偉人	izin	great man
各人	kakuzin	each person
女人	nyonin	women
小人	kodomo	child
国人	kunibito	indigenous person
凡人	bonzin	ordinary person
町人	tyoonin	townspeople
善人	zennin	good people
外人	gaizin	foreigner
仲人	nakoodo	matchmaker
倭人	wazin	Japanese person
義人	gizin	man
上人	syoonin	holy priest
玄人	kurooto	expert
客人	kyakuzin	caller
罪人	zainin	criminal
古人	kozin	ancient people
武人	buzin	military man
超人	tyoozin	superman
直人	tadabito	ordinary person
余人	yonin	others
米人	beizin	an American
和人	wazin	Japanese person
奇人	kizin	queer fellow
麗人	reizin	beautiful woman
衆人	syuuzin	the people
門人	monzin	pupil
異人	izin	foreigner
死人	sinin	corpse
盗人	nusutto	thief
貴人	kizin	aristocrat
党人	toozin	party man
狩人	karyuudo	hunter
各人	kakuzin	each person
若人	wakoodo	young person
売人	bainin	trader
才人	saizin	talented person
哲人	tetuzin	wise man
唐人	toozin	Chinese person
海人	ama	male diver
旧人	kyuuzin	paleoanthropic man
鳥人	tyoozin	aviator
世人	sezin	the people
狂人	kyoozin	lunatic
両人	ryoonin	both people
行人	koozin	passer-by
山人	sanzin	mountain folk
天人	tennin	nature and man
土人	dozin	natives
廃人	haizin	cripple
良人	ryoozin	husband
佳人	kazin	beauty
野人	yazin	rustic
流人	runin	exile
通人	tuuzin	man of the world
俗人	zokuzin	ordinary people
人人	hitobito	each person
前人	zenzin	predecessor
属人	zokuzin	personal
粋人	suizin	man of the world
里人	satobito	villager
畸人	kizin	queer fellow
下人	genin	low-rank person
舎人	toneri	servant
痴人	tizin	dunce
諸人	morobito	many people
神人	sinzin	gods and men
訴人	sonin	a suitor
雇人	yatoinin	employee
情人	zyoonin	lover
後人	koozin	posterity
用人	yoonin	manager
舟人	hunabito	sailor
牧人	bokuzin	shepherd
偏人	henzin	eccentric person
伶人	reizin	court musician
愚人	guzin	fool
猟人	ryoozin	hunter
士人	sizin	samurai
時人	zizin	contemporaries
船人	hunabito	sailor
傑人	ketuzin	outstanding person
代人	dainin	substitute
我人	warehito	myself and others
偶人	guuzin	puppet
堅人	katazin	square
成人	seizin	adult
騒人	soozin	poet
蕃人	banzin	savage
傍人	boozin	bystander
傭人	yoonin	employee
咎人	toganin	offender
佞人	neizin	flatterer
水準	suizyun	level
水泳	suiei	swimming
水産	suisan	aquatic products
水道	suidoo	water service
水面	suimen	water's surface
水素	suiso	hydrogen
水分	suibun	water
水田	suiden	paddy field
水着	mizugi	bathing suit
水域	suiiki	waters
水質	suisitu	water quality
水中	suityuu	underwater
水害	suigai	water damage
水死	suisi	drowning
水路	suiro	waterway
水深	suisin	depth of water
水平	suihei	level
水曜	suiyoo	Wednesday
水位	suii	water level
水没	suibotu	submerge
水銀	suigin	mercury
水温	suion	water temperature
水上	suizyoo	aquatic
水槽	suisoo	water tank
水源	suigen	source of river
水鳥	mizutori	waterfowl
水辺	mizube	waterside
水力	suiryoku	hydraulic power
水球	suikyuu	water polo
水脈	suimyaku	water vein
水門	suimon	sluice gate
水際	mizugiwa	beach
水墨	suiboku	water and ink
水色	mizuiro	light blue
水晶	suisyoo	crystal
水気	mizuke	moisture
水系	suikei	water system
水難	suinan	drowning
水利	suiri	water supply
水滴	suiteki	drop of water
水圧	suiatu	pressure
水虫	mizumusi	athlete's foot
水爆	suibaku	hydrogen bomb
水筒	suitoo	canteen
水流	suiryuu	water current
水兵	suihei	sailor
水生	suisei	aquatic
水稲	suitoo	wet-land rice
水仙	suisen	daffodil
水車	mizuguruma	water wheel
水玉	mizutama	drop of water
水草	mizukusa	water plant
水底	minasoko	sea or river bottom
水牛	suigyuu	water buffalo
水星	suisei	Mercury
水浴	suiyoku	a bath
水泡	suihoo	foam
水軍	suigun	navy
水口	mizuguti	a spout
水性	suisei	aqueous
水菜	mizuna	mizuna
水雷	suirai	mine
水木	mizuki	dogwood
水腫	suisyu	dropsy
水洗	suisen	rinsing with water
水防	suiboo	flood prevention
水運	suiun	water transportation
水陸	suiriku	land and water
水疱	suihoo	blister
水音	mizuoto	sound of water
水天	suiten	water and sky
水神	suizin	a water god
水心	mizugokoro	knowing how to swim
水冷	suirei	water cooling
水練	suiren	swimming practice
水月	suigetu	water and moon
水葬	suisoo	burial at sea
水盤	suiban	flower basin
水物	mizumono	a liquid
水枕	mizumakura	water-filled pillow
水柱	mizubasira	column of water
水夫	suihu	sailor
水痘	suitoo	chickenpox
水甕	mizugame	water jug
水飴	mizuame	starch syrup
水苔	mizugoke	sphagnum
水瓶	mizugame	water jug
水魚	suigyo	water and fish
水差	mizusasi	pitcher
水蜜	suimitu	white peach
水芸	mizugei	tricks with water
水圏	suiken	hydrosphere
水松	miru	stag seaweed
水雲	mozuku	mozuku
水茎	mizuguki	writing brush
水鶏	kuina	rail
水棲	suisei	aquatic
水火	suika	fire and water
水禽	suikin	waterfowl
水勢	suisei	force of water
水損	suison	flood damage
水油	mizuabura	hair oil
水禍	suika	flood disaster
水食	suisyoku	erosion
水嵩	mizukasa	volume of water
水船	mizubune	water trough
水母	kurage	jellyfish
水薬	mizugusuri	potion
水洟	mizubana	runny nose
洪水	koozui	flood
排水	haisui	drainage
浸水	sinsui	inundation
海水	kaisui	ocean water
潜水	sensui	diving
給水	kyuusui	water supply
治水	tisui	flood control
雨水	amamizu	rain water
降水	koosui	rainfall
浄水	zyoosui	clean water
用水	yoosui	irrigation water
温水	onsui	warm water
放水	hoosui	hosing down
防水	boosui	waterproofing
脱水	dassui	evaporation
香水	koosui	perfume
山水	sansui	mountain and water
汚水	osui	filthy water
出水	syussui	flood
下水	gesui	drainage
冷水	reisui	cold water
増水	zoosui	rising water
貯水	tyosui	storage of water
断水	dansui	water outage
淡水	tansui	fresh water
節水	sessui	saving water
噴水	hunsui	water fountain
利水	risui	irrigation
吸水	kyuusui	water absorption
鼻水	hanamizu	nasal mucus
塩水	ensui	salt water
漏水	roosui	leakage
流水	ryuusui	running water
清水	simizu	spring water
渇水	kassui	water shortage
湖水	kosui	lake
真水	mamizu	fresh water
泥水	doromizu	muddy water
重水	zyuusui	heavy water
配水	haisui	water supply
入水	zyusui	suicide by drowning
親水	sinsui	hydrophilic
名水	meisui	famous mineral water
着水	tyakusui	landing on the water
風水	huusui	Chinese geomancy
上水	zyoosui	water supply
湯水	yumizu	hot and cold water
廃水	haisui	wastewater
氷水	koorimizu	ice water
進水	sinsui	launching
導水	doosui	water conveyance
羊水	yoosui	amniotic fluid
加水	kasui	adding water
送水	soosui	supply of water
耐水	taisui	water-resistant
生水	namamizu	unboiled water
無水	musui	anhydrous
汗水	asemizu	sweat
秋水	syuusui	clear autumn water
破水	hasui	water breaking
垂水	tarumi	waterfall
二水	nisui	"kanji ""ice"" radical"
聖水	seisui	holy water
泉水	sensui	garden pond
揚水	yoosui	pumping up water
軟水	nansui	soft water
行水	gyoozui	tub bath
豊水	hoosui	high water
雲水	unsui	itinerant priest
硬水	koosui	hard water
注水	tyuusui	pouring water
大水	oomizu	flood
疏水	sosui	canal
天水	tensui	rain water
軽水	keisui	light water
胸水	kyoosui	pleural fluid
腹水	hukusui	ascites
疎水	sosui	canal
火水	himizu	fire and water
濁水	dakusui	muddy water
小水	syoosui	urine
溢水	issui	inundation
吃水	kissui	sea gauge
碧水	hekisui	blue water
減水	gensui	subsiding of water
神水	zinzui	water offered to God
領水	ryoosui	territorial waters
霊水	reisui	water
飲水	nomimizu	drinking water
喫水	kissui	sea gauge
平水	heisui	calm water
鉱水	koosui	mineral water
潮水	siomizu	seawater
離水	risui	takeoff
鹹水	kansui	brackish water
王水	oosui	aqua regia
潅水	kansui	sprinkling
遣水	yarimizu	stream
薪水	sinsui	fuel and water
打水	utimizu	sprinkling water
濾水	rosui	filtered water
生活	seikatu	living
生産	seisan	production
生徒	seito	pupil
生命	seimei	life
生物	seibutu	living things
生涯	syoogai	one's lifetime
生存	seizon	existence
生保	seiho	life insurance
生息	seisoku	inhabiting
生態	seitai	mode of life
生後	seigo	post-natal
生誕	seitan	birth
生還	seikan	returning alive
生前	seizen	while alive
生体	seitai	organism
生殖	seisyoku	reproduction
生地	kizi	cloth
生成	seisei	creation
生死	seisi	life and death
生鮮	seisen	fresh
生理	seiri	physiology
生育	seiiku	birth and growth
生計	seikei	livelihood
生家	seika	home
生身	namami	living flesh
生乳	seinyuu	raw milk
生来	seirai	naturally
生長	seityoo	growth
生花	seika	flower arrangement
生食	seisyoku	eating something raw
生気	seiki	life
生薬	kigusuri	crude drug
生業	seigyoo	occupation
生粋	kissui	pure
生者	syoozya	animate nature
生肉	seiniku	raw meat
生糸	kiito	raw silk thread
生母	seibo	one's real mother
生姜	syooga	ginger
生水	namamizu	unboiled water
生硬	seikoo	crude
生起	seiki	occurrence
生魚	namazakana	raw or fresh fish
生動	seidoo	vitality
生新	seisin	fresh
生類	syoorui	living things
生首	namakubi	freshly severed head
生木	namaki	live tree
生垣	ikegaki	hedge
生国	syoogoku	one's native country
生霊	ikiryoo	vengeful spirit
生彩	seisai	brilliance
生酒	kizake	pure sake
生紙	kigami	unsized paper
生録	namaroku	live recording
生々	seisei	lively
生別	seibetu	lifelong separation
生贄	ikenie	sacrifice
生簀	ikesu	fish preserve
生色	seisyoku	healthy complexion
生麩	syoohu	wheat starch
生生	seisei	lively
生娘	kimusume	virgin
生餌	ikie	live bait
生害	syoogai	commit suicide
生硬	seikoo	crude
生爪	namazume	fingernail
生滅	syoometu	birth and death
学生	gakusei	student
発生	hassei	outbreak
再生	saisei	resuscitation
厚生	koosei	welfare
人生	zinsei	life
先生	sensei	teacher
誕生	tanzyoo	birth
年生	nensei	pupil in ... year
衛生	eisei	health
更生	koosei	rehabilitation
一生	issyoo	whole life
出生	syussyoo	birth
野生	yasei	wild
共生	kyoosei	symbiosis
民生	minsei	consumer
半生	hansei	half a lifetime
芝生	sibahu	lawn
新生	sinsei	rebirth
派生	hasei	derivation
院生	insei	graduate student
蘇生	sosei	rebirth
自生	zisei	growing wild
死生	sisei	life and death
写生	syasei	sketching
植生	syokusei	vegetation
寄生	kisei	parasitism
往生	oozyoo	death
終生	syuusei	all one's life
七生	sitisyoo	seven lives
水生	suisei	aquatic
養生	yoozyoo	hygiene
園生	ensei	garden
寮生	ryoosei	boarder
優生	yuusei	eugenic
小生	syoosei	I
回生	kaisei	resurrection
長生	tyoosei	longevity
殺生	sessyoo	killing
早生	wase	early ripening rice
平生	heizei	usual
回生	kaisei	resurrection
未生	misyoo	unborn
現生	gennama	real money
幼生	yoosei	larva
今生	konzyoo	this life
実生	misyoo	seedling
衆生	syuzyoo	living things
蓬生	yomogiu	wasteland
後生	koosei	younger people
有生	yuusei	living thing
蒼生	soosei	the masses
畜生	tikusyoo	beast
胎生	taisei	viviparity
永生	eisei	eternal life
摂生	sessei	hygiene
着生	tyakusei	epiphytic
陸生	rikusei	terrestrial
晩生	bansei	slow growth
埴生	hanyuu	clay soil
畢生	hissei	lifetime
甦生	sosei	rebirth
初生	syosei	firstborn
素生	suzyoo	birth
門生	monsei	pupil
両生	ryoosei	amphibious
化生	kasei	growth
所生	syosei	birth parents
多生	tasyoo	metempsychosis
卵生	ransei	oviparity
互生	gosei	alternate
生生	seisei	lively
他生	tasyoo	previous existence
対生	taisei	opposing pairs
愚生	gusei	I
儒生	zyusei	Confucian scholar
前生	zensyoo	previous existence
叢生	soosei	dense growth
存生	zonzyoo	being alive
西部	seibu	western part
西岸	seigan	west coast
西洋	seiyoo	the west
西側	nisigawa	west side
西口	nisiguti	west entrance
西遊	seiyuu	westward trip
西方	seihoo	western direction
西南	seinan	south-west
西暦	seireki	Christian Era
西端	seitan	western edge
西北	seihoku	north-west
西日	nisibi	westering sun
西下	saika	going west
西瓜	suika	watermelon
西風	seihuu	west wind
西進	seisin	proceeding west
西経	seikei	west longitude
西土	seido	western lands
西紀	seiki	Christian era
西哲	seitetu	western philosopher
西漸	seizen	westward advance
東西	toozai	east and west
南西	nansei	southwest
北西	hokusei	northwest
以西	isei	... and westward
泰西	taisei	the Occident
以西	isei	... and westward
千代	tiyo	thousand years
千里	senri	1000 ri
千尋	tihiro	great depth
千金	senkin	1000 pounds
千鳥	tidori	plover
千秋	sensyuu	thousand years
千歳	titose	millennium
千万	senban	exceedingly
千両	senryoo	1000 ryou
千年	titose	millennium
千古	senko	all ages
千載	senzai	millennium
千万	senman	10,000,000
千鈞	senkin	1000 pounds
千慮	senryo	much thought
百千	momoti	a large number
一千	issen	1,000
川柳	senryuu	senryu
川口	kawaguti	mouth of river
川岸	kawagisi	riverbank
川端	kawabata	riverbank
川面	kawamo	river surface
川底	kawazoko	riverbed
川辺	kawabe	riverside
川原	kawara	dry river bed
川尻	kawaziri	mouth of a river
川幅	kawahaba	width of a river
川下	kawasimo	downstream
川床	kawadoko	riverbed
川瀬	kawase	rapids
川筋	kawasuzi	course of a river
川船	kawabune	riverboat
川縁	kawabuti	riverside
川蝉	kawasemi	kingfisher
河川	kasen	rivers
小川	ogawa	streamlet
谷川	tanigawa	mountain stream
古川	hurukawa	old river
大川	ookawa	big river
山川	yamakawa	mountains and rivers
先発	senpatu	forerunner
先生	sensei	teacher
先月	sengetu	last month
先制	sensei	preempt
先進	sensin	seniority
先行	senkoo	preceding
先頭	sentoo	head
先輩	senpai	senior
先手	sente	the first move
先日	senzitu	the other day
先週	sensyuu	last week
先物	sakimono	futures
先端	sentan	pointed end
先取	sensyu	earning the first
先着	sentyaku	first arrival
先番	senban	precedence
先駆	senku	forerunner
先遣	senken	sending ahead
先祖	senzo	ancestor
先代	sendai	family predecessor
先導	sendoo	guidance
先決	senketu	previous decision
先人	senzin	predecessor
先鋭	senei	radical
先々	sakizaki	distant future
先例	senrei	precedent
先天	senten	inherent
先陣	senzin	vanguard
先見	senken	foresight
先方	senpoo	companion
先達	sendatu	guide
先攻	senkoo	batting first
先鋒	senpoo	advance guard
先任	sennin	seniority
先般	senpan	some time ago
先兵	senpei	vanguard
先議	sengi	initiative
先史	sensi	prehistory
先刻	senkoku	already
先覚	senkaku	learned man
先年	sennen	former years
先約	senyaku	previous engagement
先妻	sensai	former wife
先鞭	senben	initiative
先夜	senya	few nights ago
先程	sakihodo	some time ago
先述	senzyutu	aforesaid
先哲	sentetu	ancient wise men
先王	senoo	the late king
先頃	sakigoro	recently
先学	sengaku	academic predecessor
先山	sakiyama	skilled miner
先師	sensi	former teacher
先途	sendo	crisis in a battle
先入	sennyuu	preconception
先付	sakizuke	appetizer
先夫	senpu	former husband
先賢	senken	ancient sage
先帝	sentei	the late emperor
先様	sakisama	the other party
先君	senkun	previous ruler
先考	senkoo	one's late father
先非	senpi	past sin
先便	senbin	previous letter
優先	yuusen	preference
目先	mesaki	near future
出先	desaki	one's destination
矛先	hokosaki	point of spear
指先	yubisaki	fingertip
祖先	sosen	ancestor
春先	harusaki	beginning of spring
旅先	tabisaki	destination
矢先	yasaki	arrowhead
庭先	niwasaki	in the garden
手先	tesaki	fingers
店先	misesaki	storefront
口先	kutisaki	lip service
幸先	saisaki	omen
軒先	nokisaki	edge of the eaves
機先	kisen	forestall
鼻先	hanasaki	tip of nose
穂先	hosaki	ear
後先	atosaki	front and rear
刃先	hasaki	edge of blade
剣先	kensaki	point of a sword
筆先	hudesaki	tip of brush
舌先	sitasaki	tip of tongue
互先	tagaisen	even game
真先	massaki	the head
爪先	tumasaki	toes
宛先	atesaki	address
舳先	hesaki	bow
筒先	tutusaki	nozzle
矢先	yasaki	arrowhead
肩先	katasaki	shoulder
縁先	ensaki	veranda edge
行先	ikisaki	destination
胸先	munasaki	chest
切先	kissaki	point
前年	zennen	the preceding year
前回	zenkai	previous time
前半	zenhan	first half
前日	zenzitu	previous day
前提	zentei	preamble
前期	zenki	first term
前進	zensin	advance
前月	zengetu	last month
前後	zengo	front and rear
前週	zensyuu	last week
前面	zenmen	front part
前線	zensen	front
前身	zensin	antecedents
前夜	zenya	last night
前衛	zenei	advance guard
前例	zenrei	precedent
前方	zenpoo	forward
前哨	zensyoo	outpost
前文	zenbun	preamble
前者	zensya	the former
前途	zento	future prospects
前作	zensaku	previous work
前列	zenretu	front row
前任	zennin	former
前輪	zenrin	front wheel
前々	maemae	beforehand
前兆	zentyoo	omen
前部	zenbu	front part
前述	zenzyutu	aforementioned
前科	zenka	previous conviction
前記	zenki	aforesaid
前歴	zenreki	personal history
前座	zenza	opening performance
前菜	zensai	hors d'oeuvre
前奏	zensoo	prelude
前段	zendan	preceding paragraph
前妻	zensai	ex-wife
前庭	zentei	front garden
前歯	maeba	front tooth
前髪	maegami	forelock
前言	zengen	previous remarks
前項	zenkoo	preceding paragraph
前編	zenpen	first part
前納	zennoo	prepayment
前世	zensei	antiquity
前足	maeasi	forefoot
前腕	zenwan	forearm
前駆	zenku	outrider
前史	zensi	prehistory
前門	zenmon	front gate
前金	maekin	advance payment
前景	zenkei	foreground
前山	sakiyama	skilled miner
前肢	zensi	forefoot
前掲	zenkei	above-named
前側	maegawa	front side
前人	zenzin	predecessor
前約	zenyaku	previous engagement
前車	zensya	the car ahead
前売	maeuri	advance sale
前代	zendai	previous generation
前額	zengaku	forehead
前章	zensyoo	prior chapter
前説	zensetu	former opinion
前書	zensyo	previous writing
前払	maebarai	payment in advance
前借	zensyaku	getting an advance
前端	zentan	front end
前栽	senzai	garden
前非	zenpi	past folly
前生	zensyoo	previous existence
前翅	zensi	fore-wing
午前	gozen	morning
名前	namae	name
以前	izen	ago
直前	tyokuzen	just before
事前	zizen	prior
手前	temae	before
戦前	senzen	pre-war days
駅前	ekimae	in front of station
人前	ninmae	portion of food
寸前	sunzen	on the verge
生前	seizen	while alive
建前	tatemae	face
空前	kuuzen	unprecedented
人前	hitomae	the public
出前	demae	catering
墓前	bozen	in front of a grave
腕前	udemae	ability
眼前	ganzen	before one's eyes
門前	monzen	before a gate
昼前	hirumae	forenoon
口前	kutimae	way of speaking
従前	zyuuzen	previous
板前	itamae	chef
御前	gozen	presence
気前	kimae	generosity
錠前	zyoomae	lock
面前	menzen	presence
男前	otokomae	handsome man
食前	syokuzen	before meals
神前	sinzen	before god
婚前	konzen	premarital
食前	syokuzen	before meals
産前	sanzen	prior to childbirth
両前	ryoomae	double-breasted
最前	saizen	foremost
同前	doozen	same as above
現前	genzen	before one's eyes
丹前	tanzen	large padded kimono
風前	huuzen	where the wind blows
没前	botuzen	prior to death
持前	motimae	one's nature
割前	warimae	share
夜前	yazen	last night
取前	torimae	share
大会	taikai	convention
大手	oote	major company
大幅	oohaba	big
大切	taisetu	important
大量	tairyoo	large quantity
大使	taisi	ambassador
大事	daizi	important
大人	otona	adult
大型	oogata	large
大変	taihen	very
大臣	daizin	cabinet minister
大半	taihan	majority
大賞	taisyoo	big prize
大勢	oozei	many
大戦	taisen	great war
大国	taikoku	large country
大陸	tairiku	continent
大衆	taisyuu	general public
大胆	daitan	bold
大気	taiki	atmosphere
大海	taikai	ocean
大麻	taima	hemp
大勝	taisyoo	great victory
大宮	oomiya	imperial palace
大地	daiti	ground
大豆	daizu	soya bean
大差	taisa	great difference
大物	oomono	important person
大敗	taihai	crushing defeat
大家	ooya	landlord
大筋	oosuzi	outline
大作	taisaku	epic
大台	oodai	100-yen unit
大口	ooguti	big mouth
大雨	ooame	heavy rain
大声	oogoe	loud voice
大蔵	ookura	Ministry of Finance
大根	daikon	daikon
大将	taisyoo	general
大雪	ooyuki	heavy snow
大卒	daisotu	university graduate
大腸	daityoo	large intestine
大佐	taisa	colonel
大和	yamato	Yamato
大工	daiku	carpenter
大枠	oowaku	general framework
大義	taigi	great cause
大小	daisyoo	sizes
大仰	oogyoo	exaggeration
大社	taisya	grand shrine
大名	daimyoo	daimyo
大方	ookata	perhaps
大石	ooisi	large stone
大盤	ooban	demonstration board
大局	taikyoku	general situation
大木	taiboku	large tree
大成	taisei	completion
大破	taiha	serious damage
大役	taiyaku	important task
大砲	taihoo	gun
大河	taiga	large river
大祭	taisai	grand festival
大樹	taizyu	large tree
大洋	taiyoo	ocean
大観	taikan	broad overview
大同	daidoo	largely the same
大黒	daikoku	god of wealth
大技	oowaza	bold move
大法	taihoo	basic law
大道	daidoo	main street
大空	oozora	heavens
大瓶	oobin	large bottle
大王	daioo	great king
大輪	tairin	large-flowered
大尉	taii	captain
大抵	taitei	mostly
大器	taiki	large container
大船	oobune	large boat
大柄	oogara	large build
大粒	ootubu	large grain
大奥	oooku	inner palace
大川	ookawa	big river
大脳	dainoo	cerebrum
大麦	oomugi	barley
大福	daihuku	great fortune
大病	taibyoo	serious illness
大門	oomon	large front gate
大隊	daitai	battalion
大腿	daitai	thigh
大波	oonami	billow
大字	daizi	large character
大判	ooban	large size
大体	daitai	general
大敵	taiteki	great rival
大本	oomoto	foundation
大政	taisei	sovereign power
大昔	oomukasi	great antiquity
大師	daisi	great teacher
大挙	taikyo	in force
大皿	oozara	large plate
大志	taisi	ambition
大典	taiten	state ceremony
大悟	taigo	enlightenment
大漁	tairyoo	big catch
大著	taityo	voluminous work
大望	taimoo	aspiration
大聖	taisei	great sage
大男	oootoko	great man
大穴	ooana	large hole
大群	taigun	large crowd
大目	oome	large eyes
大蛇	oroti	big snake
大全	taizen	encyclopedia
大火	taika	large fire
大吉	daikiti	excellent luck
大路	oozi	main street
大味	ooazi	lack of taste
大帝	taitei	great emperor
大智	taiti	supreme wisdom
大系	taikei	outline
大安	taian	lucky day
大罪	daizai	serious crime
大潮	oosio	spring tide
大葉	ooba	beefsteak plant
大慶	taikei	great joy
大逆	daigyaku	high treason
大軍	taigun	army
大寒	daikan	extreme cold
大君	taikun	liege lord
大抵	taitei	mostly
大部	taibu	lengthy
大老	tairoo	chief minister
大徳	daitoku	virtuous priest
大食	taisyoku	gluttony
大玉	oodama	large ball
大農	dainoo	farming
大権	taiken	supreme authority
大乗	daizyoo	Mahayana Buddhism
大公	taikoo	archduke
大喪	taisoo	Imperial mourning
大過	taika	serious error
大赦	taisya	amnesty
大便	daiben	feces
大鋸	oga	large saw
大乱	tairan	rebellion
大暑	taisyo	blistering heat
大任	tainin	important task
大宗	taisoo	leading figure
大鳥	ootori	large bird
大概	taigai	in general
大獄	taigoku	roundup
大盛	oomori	large serving
大刀	tati	long sword
大願	taigan	ambition
大兄	taikei	older brother
大層	taisoo	very much
大枚	taimai	large sum
大意	taii	synopsis
大水	oomizu	flood
大勇	taiyuu	real courage
大儀	taigi	state ceremony
大尽	daizin	rich person
大風	ookaze	gale
大業	oowaza	bold move
大言	taigen	big talk
大知	taiti	supreme wisdom
大愚	taigu	great folly or fool
大屋	ooya	landlord
大数	taisuu	great number
大形	oogata	large
大筒	oozutu	cannon
大要	taiyoo	summary
大欲	taiyoku	avarice
大虚	taikyo	the sky
大儒	taizyu	great Confucian
大足	ooasi	big feet
大祓	ooharai	great purification
大姉	daisi	Sister
大鑑	taikan	encyclopedia
大賢	taiken	great sage
大損	oozon	heavy loss
大杯	taihai	large cup
大詰	oozume	final scene
大凶	daikyoo	terrible luck
大葬	taisoo	imperial funeral
大黄	daioo	rhubarb
大股	oomata	straddle
大略	tairyaku	excellent plan
大円	daien	large circle
大形	oogyoo	exaggeration
大患	taikan	serious illness
大事	daizi	important
大難	dainan	great disaster
大白	taihaku	large cup
大厄	taiyaku	calamity
大弓	daikyuu	bow
大詔	taisyoo	imperial rescript
大酔	taisui	dead drunk
大童	oowarawa	strenuous efforts
大藩	taihan	large feudal domain
大尾	taibi	end
大様	ooyoo	largehearted
大域	taiiki	wide area
大圏	taiken	great circle
大息	taisoku	deep sigh
大蒜	ninniku	garlic
大鉈	oonata	big hatchet
拡大	kakudai	magnification
最大	saidai	biggest
重大	zyuudai	serious
巨大	kyodai	huge
短大	tandai	junior college
増大	zoodai	enlargement
膨大	boodai	huge
工大	koodai	technical college
医大	idai	medical university
偉大	idai	greatness
広大	koodai	huge
過大	kadai	excessive
多大	tadai	heavy
壮大	soodai	magnificent
一大	itidai	one large ...
肥大	hidai	swell
絶大	zetudai	tremendous
強大	kyoodai	mighty
盛大	seidai	grand
雄大	yuudai	grandeur
特大	tokudai	extra-large
甚大	zindai	very great
芸大	geidai	university of arts
寛大	kandai	tolerance
長大	tyoodai	very long
音大	ondai	college of music
莫大	bakudai	enormous
膨大	boodai	huge
誇大	kodai	exaggeration
四大	sidai	the four elements
尊大	sondai	haughtiness
正大	seidai	fairness
国大	kokudai	national university
高大	koodai	lofty
極大	kyokudai	maximum
博大	hakudai	large and wide
遠大	endai	grand
御大	ontai	boss
過大	kadai	excessive
寛大	kandai	tolerance
雄大	yuudai	grandeur
高大	koodai	lofty
厖大	boodai	huge
散大	sandai	dilation
極大	kyokudai	maximum
宏大	koodai	huge
細大	saidai	great and small
倍大	baidai	double size
至大	sidai	immense
宏大	koodai	huge
著大	tyodai	exceptionally large
粗大	sodai	coarse or rough
博大	hakudai	large and wide
男性	dansei	man
男子	dansi	youth
男女	danzyo	men and women
男児	danzi	boy
男優	danyuu	actor
男系	dankei	male lineage
男役	otokoyaku	male part or role
男爵	dansyaku	baron
男声	dansei	male voice
男気	otokoke	male presence
男前	otokomae	handsome man
男手	otokode	man's handwriting
男衆	otokosyu	men
男物	otokomono	men's things
男心	otokogokoro	male instincts
男根	dankon	penis
男色	nansyoku	sodomy
男娼	dansyoo	male prostitute
男坂	otokozaka	steeper of two hills
男妾	dansyoo	male paramour
男滝	odaki	greater waterfall
長男	tyoonan	eldest son
二男	zinan	second son
次男	zinan	second son
三男	sannan	three sons
美男	binan	handsome man
大男	oootoko	great man
山男	yamaotoko	giant
色男	irootoko	lover
嫡男	tyakunan	heir
雪男	yukiotoko	abominable snowman
下男	genan	manservant
小男	kootoko	small man
寺男	teraotoko	male temple employee
醜男	buotoko	ugly man
作男	sakuotoko	farm hand
留男	tomeotoko	tout
中心	tyuusin	center
中央	tyuuoo	centre
中止	tyuusi	suspension
中間	tyuukan	middle
中学	tyuugaku	middle school
中小	tyuusyoo	small to medium
中旬	tyuuzyun	middle of a month
中部	tyuubu	center
中継	tyuukei	relay
中堅	tyuuken	main body
中断	tyuudan	interruption
中盤	tyuuban	middle
中身	nakami	contents
中期	tyuuki	middle period
中核	tyuukaku	kernel
中毒	tyuudoku	poisoning
中立	tyuuritu	neutrality
中古	tyuuko	used
中華	tyuuka	Chinese
中道	tyuudoo	middle of the road
中年	tyuunen	middle-age
中枢	tyuusuu	centre
中世	tyuusei	Middle Ages
中絶	tyuuzetu	abortion
中傷	tyuusyoo	slander
中軸	tyuuziku	axis
中等	tyuutoo	second grade
中途	tyuuto	in the middle
中略	tyuuryaku	omission
中型	tyuugata	medium size
中庭	nakaniwa	courtyard
中高	nakadaka	convex
中性	tyuusei	neutrality
中将	tyuuzyoo	lieutenant general
中座	tyuuza	leaving one's seat
中流	tyuuryuu	mid-stream
中級	tyuukyuu	intermediate level
中佐	tyuusa	lieutenant colonel
中指	nakayubi	middle finger
中原	tyuugen	middle of a field
中腹	tyuuhuku	mountain side
中尉	tyuui	first lieutenant
中州	nakasu	sandbank
中和	tyuuwa	neutralizing
中位	tyuui	medium
中興	tyuukoo	restoration
中洲	nakasu	sandbank
中編	tyuuhen	second part
中食	tyuuziki	lunch
中庸	tyuuyoo	middle way
中肉	tyuuniku	medium build
中空	tyuukuu	hollow
中層	tyuusoo	middle part
中腰	tyuugosi	half-rising posture
中正	tyuusei	impartiality
中外	tyuugai	home and abroad
中空	nakazora	mid-air
中背	tyuuzei	average height
中味	nakami	contents
中手	nakate	mid-season crops
中耳	tyuuzi	middle ear
中篇	tyuuhen	second part
中子	nakago	core
中幕	nakamaku	middle act
中綿	nakawata	padding
中口	nakaguti	central entrance
中葉	tyuuyoo	about the middle
中風	tyuubu	palsy
中老	tyuuroo	middle age
中正	tyuusei	impartiality
中天	tyuuten	mid-air
中波	tyuuha	medium wave
中頃	nakagoro	about the middle
中程	nakahodo	middle
中音	tyuuon	mediant
中農	tyuunoo	middle-class farmer
中気	tyuuki	palsy
中形	tyuugata	medium size
中黒	nakaguro	middle dot
中蓋	nakabuta	inner lid
中震	tyuusin	moderate earthquake
中日	tyuuniti	China and Japan
中幅	tyuuhaba	medium-width cloth
集中	syuutyuu	concentration
途中	totyuu	on the way
背中	senaka	back
訪中	hootyuu	visit to China
山中	santyuu	in the mountains
空中	kuutyuu	sky
的中	tekityuu	strike home
夢中	mutyuu	daze
熱中	nettyuu	going nuts
心中	sinzyuu	double suicide
水中	suityuu	underwater
最中	saityuu	in the middle of
地中	tityuu	underground
戦中	sentyuu	during the war
海中	kaityuu	in the sea
日中	nittyuu	daytime
連中	rentyuu	colleagues
夜中	yatyuu	during the night
道中	dootyuu	along the way
街中	matizyuu	the whole town
胸中	kyootyuu	one's heart
宮中	kyuutyuu	imperial court
渦中	katyuu	vortex
日中	nittyuu	daytime
最中	saityuu	in the middle of
獄中	gokutyuu	during imprisonment
手中	syutyuu	in one's hands
命中	meityuu	a hit
市中	sityuu	in the city
町中	matinaka	downtown
夜中	yonaka	midnight
文中	buntyuu	in the document
懐中	kaityuu	one's pocket
土中	dotyuu	earth
意中	ityuu	one's mind
術中	zyuttyuu	a trick
真中	mannaka	middle
家中	iezyuu	whole family
女中	zyotyuu	maid
社中	syatyuu	in a company
眼中	gantyuu	consideration
雨中	utyuu	in the rain
陣中	zintyuu	in camp
喪中	motyuu	mourning
火中	katyuu	in the fire
家中	katyuu	whole family
暑中	syotyuu	mid-summer
寒中	kantyuu	mid-winter
在中	zaityuu	within
洛中	rakutyuu	inside the capital
年中	nenzyuu	whole year
掌中	syootyuu	in the hand
年中	nenzyuu	whole year
忙中	bootyuu	busyness
御中	ontyuu	and Company
身中	sintyuu	within one's body
人中	hitonaka	society
秘中	hityuu	in secret
禁中	kintyuu	court
殿中	dentyuu	in the palace
腹中	hukutyuu	within one
死中	sityuu	fatal situation
正中	seityuu	the exact middle
泥中	deityuu	in the mud or mire
卒中	sottyuu	cerebral stroke
霧中	mutyuu	in the fog
忌中	kityuu	mourning
必中	hittyuu	hitting the target
座中	zatyuu	gathering
直中	tadanaka	middle
折中	settyuu	compromise
昼中	hirunaka	daytime
適中	tekityuu	strike home
長官	tyookan	secretary
長期	tyooki	long time period
長男	tyoonan	eldest son
長女	tyoozyo	eldest daughter
長年	naganen	long time
長編	tyoohen	long
長打	tyooda	long hit
長寿	tyoozyu	longevity
長身	tyoosin	tall figure
長屋	nagaya	tenement house
長居	nagai	long visit
長所	tyoosyo	strong point
長老	tyooroo	eldest
長者	tyoozya	millionaire
長調	tyootyoo	major key
長蛇	tyooda	long snake
長短	tyootan	length
長靴	nagagutu	leather boots
長大	tyoodai	very long
長袖	nagasode	long sleeves
長寿	tyoozyu	longevity
長文	tyoobun	long sentence
長髪	tyoohatu	long hair
長旅	nagatabi	long trip
長兄	tyookei	eldest brother
長子	tyoosi	eldest child
長雨	nagaame	long spell of rain
長篇	tyoohen	long
長生	tyoosei	longevity
長命	tyoomei	long life
長芋	nagaimo	Chinese yam
長径	tyookei	major axis
長姉	tyoosi	eldest sister
長物	tyoobutu	something long
長手	nagate	longish
長久	tyookyuu	permanence
長湯	nagayu	long, leisurely bath
長話	nagabanasi	long talk
長石	tyooseki	feldspar
長刀	naginata	halberd
長足	tyoosoku	rapid progress
長柄	nagae	long handle
長持	nagamoti	long-lasting
長閑	nodoka	tranquil
長講	tyookoo	lengthy lecture
長針	tyoosin	hand
長円	tyooen	ellipse
長駆	tyooku	a long march
長座	tyooza	long stay
長波	tyooha	long wave
長道	nagamiti	long road
長嘆	tyootan	deep sigh
長夜	tyooya	long night
長剣	tyooken	long sword
長幼	tyooyoo	young and old
長音	tyooon	long sound
長袴	nagabakama	long hakama
長尻	nagaziri	long stay
長尻	nagaziri	long stay
長逝	tyoosei	death
長途	tyooto	long way
長路	nagamiti	long road
会長	kaityoo	president
社長	syatyoo	company president
成長	seityoo	growth
議長	gityoo	chairman
局長	kyokutyoo	bureau director
市長	sityoo	mayor
延長	entyoo	extension
課長	katyoo	section manager
総長	sootyoo	president
校長	kootyoo	principal
所長	syotyoo	chief
次長	zityoo	vice-
院長	intyoo	director
学長	gakutyoo	university president
室長	situtyoo	section chief
座長	zatyoo	chairman
身長	sintyoo	height
首長	syutyoo	head
最長	saityoo	longest
町長	tyootyoo	town headman
店長	tentyoo	shop manager
船長	sentyoo	ship's captain
館長	kantyoo	superintendent
村長	sontyoo	village headman
全長	zentyoo	over-all length
係長	kakarityoo	chief clerk
区長	kutyoo	head of a ward
機長	kityoo	pilot
組長	kumityoo	boss
署長	syotyoo	chief
艦長	kantyoo	captain
助長	zyotyoo	promotion
園長	entyoo	head of a garden
隊長	taityoo	commanding officer
体長	taityoo	length of an animal
特長	tokutyoo	forte
波長	hatyoo	wavelength
医長	ityoo	medical director
年長	nentyoo	seniority
班長	hantyoo	squad leader
伸長	sintyoo	expansion
曹長	sootyoo	master sergeant
駅長	ekityoo	station master
年長	nentyoo	seniority
副長	hukutyoo	deputy head
家長	katyoo	patriarch
慶長	keityoo	Keichou era
士長	sityoo	leading private
生長	seityoo	growth
横長	yokonaga	oblong
悠長	yuutyoo	leisurely
増長	zootyoo	growing impudent
婦長	hutyoo	head nurse
薩長	sattyoo	Satsuma and Choshu
縦長	tatenaga	oblong
夜長	yonaga	long night
伍長	gotyoo	corporal
気長	kinaga	patient
深長	sintyoo	profound
族長	zokutyoo	patriarch
寮長	ryootyoo	dormitory leader
冗長	zyootyoo	tedious
面長	omonaga	oval-faced
級長	kyuutyoo	head of class
消長	syootyoo	prosperity and decay
尾長	onaga	azure-winged magpie
足長	asinaga	long-legged
酋長	syuutyoo	chieftain
楽長	gakutyoo	bandmaster
手長	tenaga	long-armed
脚長	asinaga	long-legged
上長	zyootyoo	one's superior
職長	syokutyoo	foreman
深長	sintyoo	profound
日長	hinaga	long day
天皇	tennoo	Emperor of Japan
天然	tennen	nature
天井	tenzyoo	ceiling
天才	tensai	genius
天気	tenki	weather
天候	tenkoo	weather
天国	tengoku	paradise
天空	tenkuu	sky
天使	tensi	angel
天下	tenka	the whole world
天体	tentai	heavenly body
天文	tenmon	astronomy
天理	tenri	natural laws
天神	tenzin	heavenly god
天狗	tengu	long-nosed goblin
天敵	tenteki	natural enemy
天災	tensai	natural calamity
天地	tenti	heaven and earth
天上	tenzyoo	the heavens
天性	tensei	nature
天命	tenmei	God's will
天王	tennoo	heavenly king
天職	tensyoku	vocation
天女	tennyo	heavenly nymph
天日	tenpi	the sun
天窓	tenmado	skylight
天声	tensei	heavenly voice
天馬	tenba	flying horse
天守	tensyu	castle tower
天寿	tenzyu	natural span of life
天頂	tentyoo	zenith
天性	tensei	nature
天明	tenmei	dawn
天子	tensi	the emperor
天来	tenrai	heavenly
天心	tensin	zenith
天外	tengai	beyond the heavens
天秤	tenbin	scales
天罰	tenbatu	divine punishment
天堂	tendoo	heaven
天網	tenmoo	heaven's vengeance
天覧	tenran	imperial inspection
天誅	tentyuu	heaven's punishment
天真	tensin	naivete
天道	tentoo	the sun
天竺	tenziku	India
天佑	tenyuu	divine aid
天分	tenbun	one's nature
天賦	tenpu	natural talent
天界	tenkai	heaven
天球	tenkyuu	celestial sphere
天人	tennin	nature and man
天領	tenryoo	imperial fief
天啓	tenkei	revelation
天為	teni	providential
天涯	tengai	horizon
天水	tensui	rain water
天与	tenyo	godsend
天蓋	tengai	canopy
天幕	tenmaku	curtain
天孫	tenson	descendant of a god
天辺	teppen	top
天恵	tenkei	Heaven's blessing
天帝	tentei	Lord
天意	teni	divine will
天成	tensei	nature
天眼	tengan	the heavenly eye
天主	tensyu	Lord of Heaven
天籟	tenrai	sound of wind
天朝	tentyoo	imperial court
天運	tenun	destiny
天変	tenpen	natural calamity
天恩	tenon	blessings of heaven
天工	tenkoo	work of nature
天象	tensyoo	weather
天譴	tenken	divine punishment
天機	tenki	secret of nature
天授	tenzyu	natural gifts
天険	tenken	natural defences
天際	tensai	horizon
天資	tensi	nature
天助	tenzyo	divine aid
楽天	rakuten	optimism
雨天	uten	rainy weather
先天	senten	inherent
仰天	gyooten	being amazed
晴天	seiten	fine weather
好天	kooten	fine weather
寒天	kanten	freezing weather
弁天	benten	Benten
荒天	kooten	stormy weather
満天	manten	the whole sky
露天	roten	open air
炎天	enten	blazing heat
回天	kaiten	changing the world
曇天	donten	weather
後天	kooten	a posteriori
水天	suiten	water and sky
南天	nanten	the southern sky
昇天	syooten	death
上天	zyooten	heaven
在天	zaiten	in heaven
蒼天	sooten	blue sky
青天	seiten	blue sky
脳天	nooten	crown of head
干天	kanten	drought
一天	itten	the whole sky
梵天	bonten	Brahma-Deva
中天	tyuuten	mid-air
野天	noten	in the open
暁天	gyooten	dawn
東天	tooten	the eastern sky
九天	kyuuten	sky
衝天	syooten	high spirits
旱天	kanten	drought
電話	denwa	telephone call
電子	densi	electron
電気	denki	electricity
電力	denryoku	electric power
電車	densya	train
電池	denti	battery
電機	denki	electrical machinery
電動	dendoo	electric
電球	denkyuu	light bulb
電鉄	dentetu	electric railway
電線	densen	electric line
電化	denka	electrification
電撃	dengeki	electric shock
電柱	dentyuu	telephone pole
電流	denryuu	electric current
電灯	dentoo	electric light
電磁	denzi	electromagnetic
電光	denkoo	lightning
電報	denpoo	telegram
電器	denki	electric
電圧	denatu	voltage
電工	denkoo	electrician
電極	denkyoku	electrode
電卓	dentaku	calculator
電信	densin	telegraph
電脳	dennoo	computer
電解	denkai	electrolysis
電荷	denka	charge
電文	denbun	telegram
電熱	dennetu	electric heat
電界	denkai	electric field
電炉	denro	electric furnace
電離	denri	ionization
電位	deni	potential
電場	denba	electric field
電路	denro	electrical circuit
電鍵	denken	telegraph key
発電	hatuden	generation
家電	kaden	consumer electronics
停電	teiden	power outage
充電	zyuuden	charging
送電	sooden	electric supply
公電	kooden	official telegram
終電	syuuden	last train
漏電	rooden	short circuit
放電	hooden	electrical discharge
市電	siden	municipal railway
打電	daden	sending a telegram
外電	gaiden	foreign telegram
帯電	taiden	electrification
受電	zyuden	receiving a telegram
荷電	kaden	electric charge
国電	kokuden	national railroad
紫電	siden	purple lightning
無電	muden	wireless
誘電	yuuden	induction
空電	kuuden	static
盗電	tooden	stealing electricity
返電	henden	reply telegram
偽電	giden	false telegram
強電	kyooden	power electrics
逐電	tikuden	flight
休電	kyuuden	electricity cut-off
土地	toti	plot of land
土俵	dohyoo	arena, esp. in sumo
土曜	doyoo	Saturday
土壌	dozyoo	soil
土木	doboku	engineering works
土台	dodai	foundation
土砂	dosya	earth and sand
土日	doniti	weekend
土産	miyage	present
土器	doki	earthenware
土手	dote	embankment
土星	dosei	Saturn
土中	dotyuu	earth
土偶	doguu	figure
土鍋	donabe	earthenware pot
土間	doma	dirt floor
土着	dotyaku	aboriginal
土方	dokata	construction worker
土蔵	dozoo	walls
土用	doyoo	midsummer
土足	dosoku	shod feet
土橋	dobasi	an earthen bridge
土俗	dozoku	local customs
土葬	dosoo	burial
土石	doseki	earth and stones
土瓶	dobin	earthenware teapot
土質	dositu	soil
土煙	tutikemuri	cloud of dust
土塀	dobei	mud wall
土人	dozin	natives
土色	tutiiro	earth
土製	dosei	clay
土管	dokan	earthen pipe
土豪	dogoo	powerful local clan
土工	dokoo	earthwork
土塊	dokai	lump of earth
土鳩	dobato	domestic pigeon
土竜	muguramoti	mole
土匪	dohi	local rebels
土民	domin	native
土埃	tutibokori	dust
土釜	dogama	earthen rice cooker
土牢	tutiroo	dungeon
国土	kokudo	country
領土	ryoodo	dominion
本土	hondo	mainland
風土	huudo	natural features
全土	zendo	the whole nation
郷土	kyoodo	native place
粘土	nendo	clay
浄土	zyoodo	Pure Land
焦土	syoodo	scorched earth
赤土	akatuti	red clay
凍土	toodo	frozen soil
表土	hyoodo	top soil
黄土	oodo	earth
黒土	kokudo	black terracotta
冥土	meido	Hades
泥土	deido	mud
陶土	toodo	potter's clay
楽土	rakudo	paradise
白土	hakudo	white clay
磁土	zido	kaolin
盛土	morituti	embankment
西土	seido	western lands
壁土	kabetuti	plaster
穢土	edo	this impure world
唐土	toodo	China
耕土	koodo	arable soil
沃土	yokudo	rich soil
荒土	koodo	wasteland
底土	sokotuti	subsoil
東西	toozai	east and west
東部	toobu	eastern part
東洋	tooyoo	Orient
東方	toohoo	eastern direction
東国	toogoku	eastern country
東側	higasigawa	east side
東北	toohoku	north-east
東邦	toohoo	Oriental country
東口	higasiguti	east entrance
東宮	tooguu	crown prince
東経	tookei	east longitude
東上	toozyoo	going to Tokyo
東風	koti	east wind
東南	toonan	south-east
東雲	sinonome	daybreak
東屋	azumaya	arbor
東遊	azumaasobi	Azuma-asobi
東進	toosin	proceeding east
東征	toosei	eastern expedition
東遷	toosen	east
東漸	toozen	eastward advance
東天	tooten	the eastern sky
北東	hokutoo	northeast
南東	nantoo	southeast
以東	itoo	... and eastward
近東	kintoo	Near East
読者	dokusya	reader
読書	dokusyo	reading
読本	tokuhon	reading-book
読経	dokyoo	sutra chanting
読物	yomimono	reading matter
読後	dokugo	after reading a book
読了	dokuryoo	finish reading
読点	tooten	comma
読会	dokkai	reading
読手	yomite	reader
読図	dokuzu	reading a map
朗読	roodoku	reading aloud
解読	kaidoku	deciphering
購読	koodoku	paid subscription
音読	ondoku	reading aloud
熟読	zyukudoku	perusal
再読	saidoku	rereading
一読	itidoku	perusal
代読	daidoku	reading for another
拝読	haidoku	reading
必読	hitudoku	must-read
判読	handoku	decipherment
誤読	godoku	misreading
通読	tuudoku	reading through
精読	seidoku	intensive reading
黙読	mokudoku	reading silently
訓読	kundoku	kun'yomi
多読	tadoku	reading
査読	sadoku	peer review
併読	heidoku	secondary reading
難読	nandoku	difficult to read
閲読	etudoku	reading
味読	midoku	appreciating a book
未読	midoku	unread
訳読	yakudoku	oral translation
未読	midoku	unread
講読	koodoku	reading
輪読	rindoku	reading in turns
可読	kadoku	readable
回読	kaidoku	read in turn
句読	kutoo	punctuation
奉読	hoodoku	respectful reading
侍読	zidoku	imperial tutor
南部	nanbu	southern part
南北	nanboku	south and north
南西	nansei	southwest
南東	nantoo	southeast
南側	minamigawa	south side
南方	nanpoo	south
南下	nanka	going south
南海	nankai	southern sea
南端	nantan	southern tip
南国	nangoku	southern countries
南口	minamiguti	south entrance
南洋	nanyoo	South Seas
南蛮	nanban	southern barbarians
南風	minamikaze	south wind
南郊	nankoo	southern suburbs
南岸	nangan	south coast
南進	nansin	proceeding south
南面	nanmen	south face
南画	nanga	Southern School
南天	nanten	the southern sky
南限	nangen	southern limit
南緯	nani	southern latitude
南都	nanto	Nara
南瓜	kabotya	pumpkin
指南	sinan	instruction
以南	inan	south of
西南	seinan	south-west
東南	toonan	south-east
以南	inan	south of
二塁	nirui	second base
二男	zinan	second son
二分	nibun	halving
二子	hutago	twins
二輪	nirin	two wheels
二元	nigen	duality
二兎	nito	two rabbits
二月	nigatu	February
二葉	hutaba	bud
二成	hutanari	hermaphrodite
二流	niryuu	second-rate
二言	nigon	double-dealing
二水	nisui	"kanji ""ice"" radical"
二股	hutamata	bifurcation
二三	nisan	two or three
二死	nisi	two out
二世	nisei	nisei
二目	hutame	for a second time
二道	hutamiti	branch roads
二乗	nizyoo	squaring
二心	hutagokoro	duplicity
二八	nippati	February and August
二伸	nisin	postscript
二親	hutaoya	both parents
無二	muni	peerless
日程	nittei	schedule
日々	hibi	every day
日曜	nitiyoo	Sunday
日常	nitizyoo	ordinary
日記	nikki	diary
日系	nikkei	Japanese descent
日時	nitizi	date and time
日付	hizuke	date
日数	nissuu	a number of days
日誌	nissi	journal
日光	nikkoo	sunlight
日中	nittyuu	daytime
日没	nitibotu	sunset
日和	biyori	ideal weather
日刊	nikkan	daily issue
日課	nikka	daily lesson
日食	nissyoku	solar eclipse
日向	hinata	sunny place
日報	nippoo	daily report
日中	nittyuu	daytime
日当	nittoo	daily allowance
日陰	hikage	shade
日勤	nikkin	day shift
日用	nitiyoo	daily use
日傘	higasa	sunshade
日夜	nitiya	day and night
日産	nissan	daily output
日出	nissyutu	sunrise
日給	nikkyuu	daily wages
日月	zitugetu	sun and moon
日日	hiniti	the number of days
日和	hiyori	weather
日蔭	hikage	shade
日射	nissya	solar radiation
日参	nissan	daily visit
日頃	higoro	normally
日子	nissi	days
日直	nittyoku	day duty
日夕	nisseki	day and night
日輪	nitirin	the sun
日銭	hizeni	daily income in cash
日日	hibi	every day
日蝕	nissyoku	solar eclipse
日影	hikage	shade
日雇	hiyatoi	daily employment
日常	nitizyoo	ordinary
日暮	higure	twilight
日頃	higoro	normally
日収	nissyuu	daily income
日永	hinaga	long day
日計	nikkei	daily account
日脚	hiasi	daytime
日毎	higoto	every day
日歩	hibu	daily interest
日長	hinaga	long day
日次	nitizi	daily
日焼	hiyake	sunburn
日傭	hiyoo	daily employment
同日	doozitu	the same day
毎日	mainiti	every day
前日	zenzitu	previous day
来日	rainiti	arrival in Japan
今日	kyoo	today
在日	zainiti	in Japan
初日	syoniti	first or opening day
翌日	yokuzitu	next day
当日	toozitu	appointed day
明日	asita	tomorrow
先日	senzitu	the other day
連日	renzitu	every day
両日	ryoozitu	both days
訪日	hooniti	visit to Japan
休日	kyuuzitu	holiday
平日	heizitu	weekday
祝日	syukuzitu	national holiday
反日	hanniti	anti-Japanese
駐日	tyuuniti	resident in Japan
朝日	asahi	morning sun
昨日	kinoo	yesterday
後日	gozitu	in the future
期日	kizitu	fixed date
即日	sokuzitu	same day
土日	doniti	weekend
本日	honzitu	today
春日	syunzitu	spring day
終日	syuuzitu	all day
夕日	yuuhi	evening sun
命日	meiniti	death anniversary
親日	sinniti	pro-Japanese
半日	hanniti	half day
抗日	kooniti	anti-Japanese
曜日	yoobi	day of the week
全日	zenzitu	all days
近日	kinzitu	soon
月日	tukihi	time
旭日	kyokuzitu	rising sun
末日	matuzitu	last day
離日	riniti	departure from Japan
落日	rakuzitu	setting sun
半日	hanniti	half day
縁日	enniti	temple festival
白日	hakuzitu	bright sunshine
天日	tenpi	the sun
過日	kazitu	recently
西日	nisibi	westering sun
永日	eizitu	long spring day
日日	hiniti	the number of days
滞日	tainiti	staying in Japan
薄日	usubi	soft light
冬日	huyubi	the winter sun
祭日	saizitu	national holiday
昔日	sekizitu	old days
吉日	kitizitu	lucky day
日日	hibi	every day
排日	hainiti	anti-Japanese
他日	tazitu	some day
隔日	kakuzitu	every other day
入日	irihi	setting sun
烈日	retuzitu	blazing sun
時日	zizitu	date
週日	syuuzitu	weekday
厄日	yakubi	unlucky day
秋日	syuuzitu	autumn day
近日	kinzitu	soon
聖日	seizitu	holy day
旗日	hatabi	national holiday
悪日	akubi	unlucky day
佳日	kazitu	auspicious day
頃日	keizitu	recently
暦日	rekizitu	calendar day
幾日	ikuniti	how many days?
旬日	zyunzitu	ten-day period
中日	tyuuniti	China and Japan
寧日	neizitu	peaceful day
入院	nyuuin	hospitalization
入場	nyuuzyoo	entrance
入札	nyuusatu	bid
入社	nyuusya	joining a company
入手	nyuusyu	obtaining
入団	nyuudan	enrollment
入国	nyuukoku	entry to a country
入所	nyuusyo	admission
入居	nyuukyo	moving into
入試	nyuusi	entrance examination
入門	nyuumon	primer
入選	nyuusen	chosen
入植	nyuusyoku	settlement
入力	nyuuryoku	input
入会	nyuukai	admission
入浴	nyuuyoku	bathing
入港	nyuukoo	entry into port
入閣	nyuukaku	joining the cabinet
入金	nyuukin	deposit
入館	nyuukan	entry
入念	nyuunen	careful
入隊	nyuutai	enlistment
入部	nyuubu	joining a club
入江	irie	inlet
入室	nyuusitu	entering a room
入荷	nyuuka	arrival of goods
入来	nyuurai	august visit
入線	nyuusen	entering a track
入村	nyuuson	entering a village
入口	irikuti	entrance
入信	nyuusin	entering a faith
入城	nyuuzyoo	entry into a castle
入水	zyusui	suicide by drowning
入湯	nyuutoo	taking a hot bath
入魂	zikkon	intimacy
入校	nyuukoo	matriculation
入念	nyuunen	careful
入庫	nyuuko	warehousing
入魂	zikkon	intimacy
入唐	nittoo	visiting Tang China
入獄	nyuugoku	imprisonment
入構	nyuukoo	act of entrance
入超	nyuutyoo	excess of imports
入日	irihi	setting sun
入滅	nyuumetu	dying
入歯	ireba	false tooth
入寂	nyuuzyaku	death of a priest
入射	nyuusya	incidence
入京	nyuukyoo	entering the capital
入貢	nyuukoo	paying tribute
入相	iriai	sunset
入牢	nyuuroo	imprisonment
入海	iriumi	bay
入質	nyuusiti	pawning
入用	nyuuyoo	need
入用	nyuuyoo	need
入洛	nyuuraku	proceeding to Kyoto
入神	nyuusin	inspiration
入墨	irezumi	tattoo
入寇	nyuukoo	invasion
導入	doonyuu	introduction
輸入	yunyuu	importation
購入	koonyuu	purchase
収入	syuunyuu	income
加入	kanyuu	becoming a member
投入	toonyuu	throwing into
参入	sannyuu	entering
介入	kainyuu	intervention
侵入	sinnyuu	penetration
突入	totunyuu	rushing into
混入	konnyuu	mixing
記入	kinyuu	entry
流入	ryuunyuu	afflux
注入	tyuunyuu	pouring
納入	noonyuu	payment
歳入	sainyuu	annual revenue
乱入	rannyuu	trespassing
進入	sinnyuu	penetration
搬入	hannyuu	taking in
挿入	soonyuu	insertion
編入	hennyuu	admission
新入	sinnyuu	newly arrived
算入	sannyuu	factoring in
転入	tennyuu	move in
移入	inyuu	importation
潜入	sennyuu	infiltration
吸入	kyuunyuu	inhalation
封入	huunyuu	enclose
没入	botunyuu	immersion
預入	yonyuu	deposit
立入	tatiiri	entering
貫入	kannyuu	penetration
繰入	kuriire	inward transfer
受入	ukeire	receiving
茶入	tyaire	tea container
仕入	siire	stocking
闖入	tinnyuu	intrusion
先入	sennyuu	preconception
申入	moosiire	proposal
押入	osiire	closet
代入	dainyuu	substitution
湾入	wannyuu	embayment
嵌入	kannyuu	setting in
年度	nendo	fiscal year
年間	nenkan	year
年金	nenkin	annuity
年代	nendai	age
年齢	nenrei	age
年間	nenkan	year
年生	nensei	pupil in ... year
年末	nenmatu	end-of-year
年度	nendo	fiscal year
年収	nensyuu	annual income
年代	nendai	age
年俸	nenpoo	annual salary
年々	nennen	years
年次	nenzi	annual
年数	nensuu	number of years
年率	nenritu	annual rate
年余	nenyo	more than a year
年配	nenpai	elderly
年度	nendo	fiscal year
年上	tosiue	older
年下	tosisita	younger
年来	nenrai	for some years
年月	tosituki	months and years
年寄	tosiyori	old people
年産	nensan	annual production
年賀	nenga	New Year's greetings
年表	nenpyoo	chronological tables
年会	nenkai	conference
年長	nentyoo	seniority
年輪	nenrin	annual tree ring
年始	nensi	New Year's call
年商	nensyoo	turnover
年利	nenri	annual interest rate
年額	nengaku	yearly amount
年鑑	nenkan	yearbook
年長	nentyoo	seniority
年限	nengen	length of time
年少	nensyoo	youth
年功	nenkoo	long service
年刊	nenkan	annual publication
年譜	nenpu	chronological record
年号	nengoo	name of an era
年貢	nengu	annual tribute
年報	nenpoo	annual report
年少	nensyoo	youth
年来	nenrai	for some years
年央	nenoo	mid-year
年中	nenzyuu	whole year
年中	nenzyuu	whole year
年増	tosima	mature woman
年波	tosinami	old age
年頃	tosigoro	approximate age
年端	tosiha	age
年別	nenbetu	by years
年輩	nenpai	elderly
年年	nennen	years
年令	nenrei	age
年忌	nenki	death anniversary
年賦	nenpu	annual installment
昨年	sakunen	last year
今年	kotosi	this year
来年	rainen	next year
少年	syoonen	boy
前年	zennen	the preceding year
周年	syuunen	whole year
毎年	maitosi	every year
半年	hantosi	half year
青年	seinen	youth
同年	doonen	that year
定年	teinen	retirement age
長年	naganen	long time
近年	kinnen	recent years
学年	gakunen	year in school
翌年	yokunen	following year
例年	reinen	year
平年	heinen	non-leap year
成年	seinen	adult age
新年	sinnen	New Year
去年	kyonen	last year
晩年	bannen	last years
中年	tyuunen	middle-age
若年	zyakunen	youth
光年	koonen	light year
往年	oonen	former
通年	tuunen	all year
老年	roonen	old age
元年	gannen	first year
隔年	kakunen	biannually
本年	honnen	year
享年	kyoonen	one's age at death
後年	koonen	future years
壮年	soonen	prime of life
積年	sekinen	years
永年	einen	long time
元年	gannen	first year
幼年	yoonen	childhood
経年	keinen	passing of years
初年	syonen	first year
多年	tanen	many years
暦年	rekinen	calendar year
没年	botunen	one's age at death
実年	zitunen	one's actual age
厄年	yakudosi	unlucky year
先年	sennen	former years
豊年	hoonen	fruitful year
高年	koonen	old age
亥年	idosi	year of the boar
例年	reinen	year
千年	titose	millennium
当年	toonen	the present year
明年	myoonen	next year
光年	koonen	light year
旧年	kyuunen	the old year
戌年	inudosi	year of the dog
停年	teinen	retirement age
年年	nennen	years
閏年	uruudosi	leap year
幾年	ikutose	number of years
行年	gyoonen	age at one's death
連年	rennen	every year
凶年	kyoonen	bad year
客年	kakunen	last year
弱年	zyakunen	youth
丁年	teinen	adulthood
白星	sirobosi	white circle
白書	hakusyo	white paper
白人	hakuzin	white person
白紙	hakusi	blank paper
白馬	hakuba	white horse
白熱	hakunetu	white heat
白鳥	hakutyoo	swan
白髪	hakuhatu	white hair
白黒	sirokuro	black and white
白露	siratuyu	glistening dew
白樺	sirakanba	Japanese white birch
白骨	hakkotu	bone
白地	sirozi	white background
白色	hakusyoku	white
白球	hakkyuu	white ball
白菜	hakusai	Chinese cabbage
白波	siranami	whitecaps
白羽	siraha	white feather
白石	siroisi	white stone
白身	siromi	white of egg
白昼	hakutyuu	daytime
白衣	hakui	white robe
白旗	hakki	white flag
白米	hakumai	rice
白金	hakkin	platinum
白票	hakuhyoo	blank ballot
白壁	sirakabe	white plaster wall
白洲	sirasu	bar of white sand
白虎	byakko	White Tiger
白子	sirako	soft roe
白日	hakuzitu	bright sunshine
白線	hakusen	white line
白木	siraki	plain wood
白雲	sirakumo	white clouds
白銀	hakugin	silver
白玉	siratama	white gem
白梅	hakubai	white plum blossoms
白寿	hakuzyu	99th birthday
白磁	hakuzi	white porcelain
白夜	byakuya	white night
白状	hakuzyoo	confession
白亜	hakua	chalk
白濁	hakudaku	cloudiness
白糸	siraito	white thread
白痴	hakuti	idiot
白眉	hakubi	fine example
白扇	hakusen	white fan
白浪	siranami	whitecaps
白酒	sirozake	sweet white sake
白州	sirasu	bar of white sand
白桃	hakutoo	white peach
白砂	hakusya	white sand
白菊	siragiku	white chrysanthemum
白癬	hakusen	scalp ringworm
白蓮	byakuren	white lotus
白雨	hakuu	rain shower
白魚	sirauo	icefish
白粉	osiroi	powder
白目	sirome	whites of the eyes
白斑	hakuhan	white or bright spot
白眼	hakugan	whites of the eyes
白檀	byakudan	sandalwood
白土	hakudo	white clay
白光	hakkoo	white light
白墨	hakuboku	blackboard chalk
白湯	sayu	hot water
白楊	hakuyoo	Japanese aspen
白炭	sirozumi	white charcoal
白熊	haguma	yak tail hair
白狐	byakko	albino fox
白刃	hakuzin	drawn sword
白描	hakubyoo	plain sketch
白妙	sirotae	white cloth
白面	hakumen	fair complexion
白話	hakuwa	colloquial Chinese
白茶	siratya	light brown
白茅	tigaya	cogon grass
白兵	hakuhei	unsheathed sword
白魔	hakuma	heavy snowfall
白皙	hakuseki	white
白肌	sirahada	white-coloured skin
白帆	siraho	white sail
白樫	sirakasi	quercus myrsinifolia
白蟻	siroari	termite
白太	sirata	sapwood
空白	kuuhaku	blank space
紅白	koohaku	red and white
告白	kokuhaku	confession
自白	zihaku	confession
明白	meihaku	obvious
余白	yohaku	blank space
潔白	keppaku	innocence
面白	omosiro	amusing
漂白	hyoohaku	blanching
純白	zyunpaku	pure white
独白	dokuhaku	monologue
潔白	keppaku	innocence
色白	iroziro	fair-skinned
卵白	ranpaku	white of an egg
黒白	kurosiro	black and white
上白	zyoohaku	first-class rice
太白	taihaku	Venus
精白	seihaku	refining
蒼白	soohaku	pale
表白	hyoohaku	expression
淡白	tanpaku	light
蛋白	tanpaku	egg white
建白	kenpaku	petition
科白	serihu	speech
敬白	keihaku	Yours Sincerely
真白	massiro	pure white
腕白	wanpaku	naughtiness
黄白	koohaku	yellow and white
真白	massiro	pure white
大白	taihaku	large cup
雪白	seppaku	snow-white
半白	hanpaku	grayish color
飛白	kasuri	splash pattern
裏白	uraziro	Gleichenia japonica
八幡	hatiman	Hachiman
八角	hakkaku	octagon
八月	hatigatu	August
八重	yae	multilayered
八雲	yakumo	thick clouds
八紘	hakkoo	the eight directions
八方	happoo	all sides
八丁	hattyoo	skillfulness
八百	yao	eight hundred
八朔	hassaku	Hassaku orange
八頭	yatugasira	form of taro
八卦	hakke	eight trigrams
八反	hattan	twilled fabric
八手	yatude	Japanese fatsia
八端	hattan	twilled fabric
八分	hatibu	eight-tenths
尺八	syakuhati	shakuhachi
二八	nippati	February and August
半分	hanbun	half
半年	hantosi	half year
半数	hansuu	half the number
半減	hangen	reduction by half
半面	hanmen	half the face
半額	hangaku	half
半島	hantoo	peninsula
半径	hankei	radius
半生	hansei	half a lifetime
半月	hantuki	half-moon
半壊	hankai	partial destruction
半身	hansin	half the body
半日	hanniti	half day
半々	hanhan	half and half
半田	handa	solder
半袖	hansode	short sleeves
半端	hanpa	remnant
半値	hanne	half price
半期	hanki	half-term
半日	hanniti	half day
半旗	hanki	flag at half-mast
半期	hanki	half-term
半月	hantuki	half-moon
半円	hanen	semicircle
半球	hankyuu	hemisphere
半周	hansyuu	semicircle
半熟	hanzyuku	half-cooked
半裸	hanra	half-nakedness
半鐘	hansyoo	fire alarm
半切	hansetu	cutting in half
半畳	hanzyoo	half tatami mat
半音	hanon	semitone
半幅	hanhaba	half-width cloth
半夜	hanya	midnight
半開	hankai	half-open
半玉	hangyoku	child geisha
半休	hankyuu	half holiday
半平	hanpen	pounded fish cake
半時	hantoki	little while
半解	hankai	only half understood
半間	hanma	something unfinished
半間	hanma	something unfinished
半白	hanpaku	grayish color
半途	hanto	halfway
半道	hanmiti	half a ri
半截	hansetu	cutting in half
時半	zihan	about an hour
後半	koohan	second half
前半	zenhan	first half
大半	taihan	majority
後半	koohan	second half
折半	seppan	half
過半	kahan	the greater part
夜半	yahan	midnight
丁半	tyoohan	odd and even numbers
一半	ippan	half
百科	hyakka	many objects
百姓	hyakusyoo	farmer
百合	yuri	lily
百害	hyakugai	great damage
百貨	hyakka	all kinds of goods
百薬	hyakuyaku	sundry remedies
百獣	hyakuzyuu	all kinds of animals
百代	hyakudai	long era
百舌	mozu	shrike
百足	mukade	centipede
百事	hyakuzi	all
百態	hyakutai	various phases
百味	hyakumi	all kinds
百官	hyakkan	all the officials
百歳	momotose	century
百般	hyappan	all
百千	momoti	a large number
百方	hyappoo	in every way
百計	hyakkei	all means
百行	hyakkoo	all acts
百錬	hyakuren	well-tempered
凡百	bonpyaku	many
八百	yao	eight hundred
父親	titioya	father
父母	titihaha	father and mother
父子	husi	father and child
父系	hukei	agnate
父性	husei	paternity
父上	titiue	father
父祖	huso	ancestors
父権	huken	paternal rights
父兄	hukei	guardians
父君	hukun	father
父老	huroo	elder
祖父	sohu	grandfather
義父	gihu	father-in-law
叔父	ozi	uncle
神父	sinpu	Catholic priest
実父	zippu	father
伯父	ozi	uncle
養父	yoohu	foster father
親父	oyazi	one's father
亡父	boohu	my deceased father
継父	keihu	stepfather
異父	ihu	different father
家父	kahu	one's father
老父	roohu	old father
岳父	gakuhu	father-in-law
厳父	genpu	your honored father
慈父	zihu	affectionate father
教父	kyoohu	godfather
尊父	sonpu	your father
師父	sihu	fatherly master
分析	bunseki	analysis
分野	bunya	field
分離	bunri	separation
分間	hunkan	~ minutes interval
分裂	bunretu	split
分割	bunkatu	partition
分担	buntan	apportionment
分類	bunrui	classification
分解	bunkai	disassembly
分配	bunpai	division
分科	bunka	department
分散	bunsan	dispersion
分断	bundan	dividing into parts
分譲	bunzyoo	lots
分子	bunsi	numerator
分社	bunsya	branch shrine
分布	bunpu	distribution
分別	hunbetu	discernment
分化	bunka	specialization
分泌	bunpitu	secretion
分数	bunsuu	fraction
分岐	bunki	divergence
分量	bunryoo	amount
分娩	bunben	delivery
分業	bungyoo	division of labor
分校	bunkoo	branch school
分身	bunsin	parturition
分限	bungen	social standing
分乗	bunzyoo	riding separately
分派	bunpa	denominations
分室	bunsitu	detached office
分館	bunkan	annex
分冊	bunsatu	separate volume
分与	bunyo	distribution
分立	bunritu	segregation
分家	bunke	branch family
分母	bunbo	denominator
分光	bunkoo	spectrum
分会	bunkai	branch
分団	bundan	branch
分売	bunbai	selling separately
分隊	buntai	squad
分署	bunsyo	substation
分流	bunryuu	distributary
分明	bunmei	clearness
分有	bunyuu	partial ownership
分遣	bunken	detachment
分節	bunsetu	articulation
分極	bunkyoku	polarization
分宿	bunsyuku	billeting
分銅	hundoo	weight
分掌	bunsyoo	division of duties
分際	bunzai	social standing
分針	hunsin	minute hand
分秒	hunbyoo	moment
分明	hunmyoo	clearness
分筆	bunpitu	subdivision
分列	bunretu	filing off
分封	bunpoo	hiving off
分力	bunryoku	component of force
分界	bunkai	demarcation
分脈	bunmyaku	branch
分詞	bunsi	participle
自分	zibun	myself
処分	syobun	disposal
部分	bubun	portion
十分	zyuubun	plenty
半分	hanbun	half
気分	kibun	feeling
配分	haibun	distribution
成分	seibun	ingredient
身分	mibun	social position
水分	suibun	water
区分	kubun	division
当分	toobun	for the present
二分	nibun	halving
塩分	enbun	salt
随分	zuibun	very
余分	yobun	extra
回分	kaibun	batch
見分	kenbun	inspection
随分	zuibun	very
親分	oyabun	boss
鉄分	tetubun	iron
糖分	toobun	amount of sugar
多分	tabun	perhaps
油分	yubun	oil content
子分	kobun	henchman
充分	zyuubun	plenty
食分	syokubun	phase of an eclipse
養分	yoobun	nourishment
本分	honbun	one's duty
春分	syunbun	vernal equinox
領分	ryoobun	territory
時分	zibun	time
増分	zoobun	incremental
名分	meibun	justification
性分	syoobun	nature
秋分	syuubun	autumnal equinox
寸分	sunbun	tiny bit
追分	oiwake	forked road
検分	kenbun	inspection
時分	zibun	time
余分	yobun	extra
何分	nanibun	some
過分	kabun	excessive
微分	bibun	differential
天分	tenbun	one's nature
職分	syokubun	one's duty
幾分	ikubun	somewhat
過分	kabun	excessive
積分	sekibun	integral
内分	naibun	secret
客分	kyakubun	guest
差分	sabun	diff
両分	ryoobun	bisect
持分	motibun	share
通分	tuubun	reduce
平分	heibun	bisection
九分	kubu	nine parts
士分	sibun	status of samurai
五分	gobu	half
線分	senbun	line segment
夜分	yabun	evening
灰分	kaibun	ash
均分	kinbun	equal division
可分	kabun	divisible
五分	gobu	half
得分	tokubun	profit
八分	hatibu	eight-tenths
聞香	bunkoo	smelling incense
新聞	sinbun	newspaper
聴聞	tyoomon	listening
見聞	kenbun	information
醜聞	syuubun	scandal
伝聞	denbun	hearsay
異聞	ibun	strange tale
風聞	huubun	rumour
外聞	gaibun	reputation
旧聞	kyuubun	old news
寡聞	kabun	limited information
艶聞	enbun	love affair
側聞	sokubun	casually hearing
仄聞	sokubun	casually hearing
奇聞	kibun	strange news
余聞	yobun	gossip
逸聞	itubun	something unheard of
上聞	zyoobun	an imperial hearing
声聞	syoomon	sravaka
内聞	naibun	secret
未聞	mimon	unheard
母親	hahaoya	mother
母子	bosi	mother and child
母国	bokoku	one's homeland
母校	bokoo	alma mater
母乳	bonyuu	mother's milk
母性	bosei	motherhood
母屋	moya	purlin
母港	bokoo	home port
母語	bogo	mother tongue
母船	bosen	depot ship
母艦	bokan	mother ship
母音	boin	vowel
母系	bokei	maternal line
母胎	botai	womb
母上	hahaue	mother
母趾	ERROR	big toe
母印	boin	thumbprint
母衣	horo	canopy
母型	bokei	matrix
母堂	bodoo	mother
母権	boken	maternal rights
母后	bokoo	empress dowager
祖母	sobo	grandmother
父母	titihaha	father and mother
空母	kuubo	aircraft carrier
義母	gibo	mother-in-law
実母	zitubo	mother
酵母	koobo	yeast
叔母	oba	aunt
聖母	seibo	holy mother
国母	kokubo	empress
伯母	oba	aunt
乳母	onba	wet nurse
継母	mamahaha	stepmother
老母	roobo	old mother
分母	bunbo	denominator
養母	yoobo	foster mother
異母	ibo	different mother
雲母	unmo	mica
生母	seibo	one's real mother
寮母	ryoobo	housemother
慈母	zibo	affectionate mother
賢母	kenbo	wise mother
同母	doobo	same mother
字母	zibo	letter
水母	kurage	jellyfish
北部	hokubu	northern part
北東	hokutoo	northeast
北方	hoppoo	northern
北側	kitagawa	north side
北西	hokusei	northwest
北上	hokuzyoo	going north
北国	kitaguni	northern provinces
北口	kitaguti	north entrance
北風	kitakaze	north wind
北端	hokutan	northern extremity
北緯	hokui	north latitude
北郊	hokkoo	northern suburbs
北限	hokugen	northern limit
北洋	hokuyoo	northern waters
北岸	hokugan	north coast
北門	kitamon	north gate
北辺	hokuhen	northern extremity
北面	hokumen	north face
北狄	hokuteki	Northern Di people
南北	nanboku	south and north
敗北	haiboku	defeat
東北	toohoku	north-east
以北	ihoku	north of
西北	seihoku	north-west
以北	ihoku	north of
木造	mokuzoo	wooden
木材	mokuzai	lumber
木製	mokusei	wooden
木曜	mokuyoo	Thursday
木々	kigi	every tree
木版	mokuhan	wood-block printing
木戸	kido	wicket gate
木工	mokkoo	woodworking
木星	mokusei	Jupiter
木綿	momen	cotton
木質	mokusitu	woody
木目	mokume	grain
木陰	kokage	shade of tree
木立	kodati	grove of trees
木場	kiba	lumberyard
木炭	mokutan	charcoal
木馬	mokuba	wooden horse
木片	mokuhen	block
木刀	bokutoo	wooden sword
木本	mokuhon	tree
木型	kigata	wooden form
木口	kiguti	grade of wood
木管	mokkan	woodwind
木札	kihuda	wooden tag
木酢	mokusaku	wood vinegar
木地	kizi	wood grain
木肌	kihada	bark of a tree
木魚	mokugyo	fish gong
木琴	mokkin	xylophone
木瓜	boke	Japanese quince
木霊	kodama	echo
木蓮	mokuren	lily magnolia
木骨	mokkotu	wooden frame
木犀	mokusei	fragrant olive
木賊	tokusa	scouring rushes
木偶	deku	wooden figure
木石	bokuseki	trees and stones
木通	akebi	chocolate-vine
木屑	kikuzu	wood chips
木耳	kikurage	cloud ear mushroom
木菟	mimizuku	horned owl
木蘭	mokuren	lily magnolia
木蝋	mokuroo	Japan wax
木靴	kigutu	wooden shoes
木皮	mokuhi	tree bark
木槿	mukuge	rose of Sharon
木蔭	kokage	shade of tree
木灰	kibai	wood ashes
木組	kigumi	wooden framework
木剣	bokken	bokken
木精	mokusei	wood alcohol
木端	koppa	wood chip
木杯	mokuhai	wooden cup
木仏	kibutu	wooden Buddha
木舞	komai	laths
木末	konure	twigs
木苺	kiitigo	raspberry
木訥	bokutotu	unsophisticated
土木	doboku	engineering works
樹木	zyumoku	trees and shrubs
青木	aoki	Japanese laurel
荒木	araki	logs in bark
苗木	naegi	seedling
並木	namiki	roadside tree
大木	taiboku	large tree
植木	ueki	garden shrubs
草木	kusaki	plants
本木	motoki	original stock
巨木	kyoboku	big tree
笠木	kasagi	coping
材木	zaimoku	lumber
啄木	takuboku	woodpecker
倒木	tooboku	fallen tree
丸木	maruki	log
庭木	niwaki	garden tree
流木	ryuuboku	driftwood
白木	siraki	plain wood
版木	hangi	block
枕木	makuragi	sleeper
低木	teiboku	shrub
原木	genboku	pulpwood
赤木	akagi	bishop wood
高木	kooboku	tall tree
老木	rooboku	old tree
若木	wakagi	young tree
水木	mizuki	dogwood
真木	maki	yew plum pine
正木	masaki	Japanese spindletree
立木	tatiki	standing tree
神木	sinboku	sacred tree
朽木	kutiki	decayed tree
横木	yokogi	crosspiece
板木	hangi	block
末木	uraki	treetop
香木	kooboku	fragrant wood
雁木	gangi	stepped pier
卯木	utugi	deutzia
生木	namaki	live tree
枯木	kareki	dead tree
腕木	udeki	crossarm
積木	tumiki	building blocks
撞木	syumoku	wooden bell hammer
新木	araki	unseasoned timber
寄木	yosegi	wooden mosaic
棟木	munagi	ridgepole
垂木	taruki	rafter
台木	daigi	stock
錦木	nisikigi	winged spindle-tree
霊木	reiboku	sacred tree
喬木	kyooboku	tall tree
梶木	kaziki	marlin
空木	utugi	deutzia
用木	yooboku	timber
檜木	hinoki	hinoki cypress
坑木	kooboku	mine timbers
宿木	yadorigi	mistletoe
定木	zyoogi	ruler
潅木	kanboku	bush
伐木	batuboku	felling
浮木	ukigi	driftwood
接木	tugiki	grafting
梁木	ryooboku	beam
本文	honbun	text
本部	honbu	headquarters
本社	honsya	head office
本人	honnin	the person himself
本来	honrai	originally
本棚	hondana	bookshelves
本当	hontoo	truth
本体	hontai	substance
本名	honmyoo	real name
本音	honne	real intention
本質	honsitu	essence
本紙	honsi	this newspaper
本書	honsyo	text
本番	honban	performance
本物	honmono	genuine article
本店	honten	head office
本土	hondo	mainland
本局	honkyoku	main office
本欄	honran	this column
本気	honki	seriousness
本選	honsen	final selection
本命	honmei	favorite
本業	hongyoo	principal occupation
本件	honken	this matter
本塁	honrui	base
本日	honzitu	today
本場	honba	home
本位	honi	standard
本国	hongoku	one's own country
本館	honkan	main building
本領	honryoo	speciality
本腰	hongosi	strenuous effort
本能	honnoo	instinct
本島	hontoo	main island
本屋	honya	bookstore
本家	honke	head house
本隊	hontai	main body
本拠	honkyo	stronghold
本省	honsyoo	this ministry
本気	honki	seriousness
本丸	honmaru	inner citadel
本堂	hondoo	main temple building
本山	honzan	head temple
本心	honsin	true feelings
本木	motoki	original stock
本流	honryuu	main current
本職	honsyoku	principal occupation
本殿	honden	main shrine
本年	honnen	year
本道	hondoo	highway
本線	honsen	main line
本筋	honsuzi	main thread
本意	honi	one's real intent
本性	honsyoo	true character
本宮	honguu	main shrine
本舗	honpo	head office
本震	honsin	main shock
本分	honbun	one's duty
本校	honkoo	main school
本編	honpen	original story
本葬	honsoo	formal funeral
本則	honsoku	rules
本題	hondai	main question
本旨	honsi	main object
本陣	honzin	troop headquarters
本邦	honpoo	this country
本元	honmoto	origin
本誌	honsi	this magazine
本手	honte	one's true ability
本朝	hontyoo	this land
本有	honyuu	innateness
本妻	honsai	one's legal wife
本科	honka	regular course
本箱	honbako	bookcase
本県	honken	this prefecture
本代	hondai	money for books
本論	honron	main discourse
本歌	motouta	original verse poem
本学	hongaku	this university
本草	honzoo	plants
本訴	honso	suit
本義	hongi	true meaning
本源	hongen	origin
本管	honkan	main pipe
本案	honan	this plan
本務	honmu	duty
本稿	honkoo	this manuscript
本船	honsen	mother ship
本字	honzi	Chinese character
本邸	hontei	principal residence
本田	honden	rice paddy
本俸	honpoo	regular salary
本初	honsyo	beginning
本署	honsyo	police headquarters
本営	honei	headquarters
本会	honkai	formal meeting
本膳	honzen	regular dinner
本式	honsiki	formal
本式	honsiki	formal
本章	honsyoo	this chapter
本官	honkan	one's official post
本然	honzen	disposition
本末	honmatu	essence and fringe
基本	kihon	foundation
資本	sihon	funds
抜本	bappon	eradication
絵本	ehon	picture book
脚本	kyakuhon	script
根本	konpon	root
元本	ganpon	principal
台本	daihon	script
手本	tehon	copybook
原本	genpon	the original
古本	huruhon	secondhand book
標本	hyoohon	example
見本	mihon	sample
読本	tokuhon	reading-book
藤本	toohon	climbing trees
副本	hukuhon	duplicate
製本	seihon	book making
写本	syahon	manuscript
謄本	toohon	certified copy
大本	oomoto	foundation
旗本	hatamoto	shogunal vassal
拓本	takuhon	rubbed copy
貸本	kasihon	books for loan
教本	kyoohon	textbook
木本	mokuhon	tree
刊本	kanpon	published book
定本	teihon	revised edition
蔵本	zoohon	one's library
春本	syunpon	pornographic book
完本	kanpon	complete set
絹本	kenpon	silk used in artwork
抄本	syoohon	excerpt
訳本	yakuhon	translated book
納本	noohon	delivery of books
豆本	mamehon	miniature book
正本	syoohon	book of registration
丸本	maruhon	reciter's book
底本	teihon	original text
異本	ihon	different edition
赤本	akahon	pulp fiction
院本	inpon	drama
草本	soohon	herbs
種本	tanehon	source book
粉本	hunpon	copy
複本	hukuhon	duplicate
円本	enpon	one-yen book
稿本	koohon	manuscript
欠本	keppon	missing volume
秘本	hihon	treasured book
校本	koohon	annotated textbook
毎日	mainiti	every day
毎年	maitosi	every year
毎週	maisyuu	every week
毎月	maituki	every month
毎回	maikai	every time
毎朝	maiasa	every morning
毎晩	maiban	every night
毎度	maido	each time
毎夜	maiyo	every evening
毎食	maisyoku	every meal
毎秒	maibyoo	every second
毎夕	maiyuu	every evening
毎期	maiki	every term
毎時	maizi	every hour
毎次	maizi	every time
夜毎	yogoto	every night
日毎	higoto	every day
万能	bannoo	all-purpose
万博	banpaku	world fair
万全	banzen	perfection
万一	maniti	emergency
万事	banzi	all
万感	bankan	flood of emotions
万里	banri	thousands of miles
万端	bantan	all
万国	bankoku	all countries
万物	banbutu	all things
万歳	banzai	"crying ""banzai"" "
万策	bansaku	all means
万丈	banzyoo	hurrah!
万有	banyuu	all things
万世	bansei	all ages
万作	mansaku	witch hazel
万死	bansi	certain death
万雷	banrai	heavy thunder
万民	banmin	all people
万代	bandai	thousands of years
万象	bansyoo	all creation
万緑	banryoku	myriad green leaves
万引	manbiki	shoplifting
万古	banko	perpetuity
万延	manen	Man'en era
万難	bannan	many obstacles
万力	manriki	vise
万骨	bankotu	thousands of lives
万般	banpan	all things
万両	manryoo	Ardisia crenata
万巻	mangan	many scrolls
万才	banzai	"crying ""banzai"" "
万機	banki	state affairs
万金	mankin	immense sum
万屋	yorozuya	general merchant
万言	mangen	many words
万邦	banpoo	all nations
万障	bansyoo	all obstacles
万夫	banpu	many people
万頃	bankei	vast expanse
万代	yorozuyo	thousands of years
万斛	bankoku	copious
万朶	banda	many branches
巨万	kyoman	huge fortune
千万	senban	exceedingly
千万	senman	10,000,000
名誉	meiyo	honor
名人	meizin	master
名前	namae	name
名簿	meibo	register of names
名目	meimoku	name
名義	meigi	name
名称	meisyoo	name
名門	meimon	noted family
名作	meisaku	masterpiece
名鑑	meikan	directory
名所	meisyo	famous place
名物	meibutu	famous product
名刺	meisi	business card
名曲	meikyoku	famous music
名手	meisyu	master
名画	meiga	famous picture
名言	meigen	wise saying
名声	meisei	fame
名残	nagori	remains
名品	meihin	fine product
名跡	myooseki	family name
名産	meisan	noted product
名著	meityo	famous book
名字	myoozi	surname
名城	meizyoo	fine castle
名馬	meiba	fine or famous horse
名山	meizan	famous mountain
名札	nahuda	name plate
名演	meien	fine performance
名句	meiku	famous saying
名宝	meihoo	famous treasure
名月	meigetu	harvest moon
名取	natori	accredited master
名医	meii	noted doctor
名工	meikoo	craftsman
名詞	meisi	noun
名匠	meisyoo	master craftsman
名水	meisui	famous mineral water
名店	meiten	well-known store
名家	meika	distinguished family
名分	meibun	justification
名刹	meisatu	famous temple
名案	meian	good idea
名士	meisi	celebrity
名代	nadai	well-known
名主	nanusi	village headman
名犬	meiken	fine dog
名刀	meitoo	famous sword
名君	meikun	wise ruler
名僧	meisoo	noted priest
名花	meika	celebrated flower
名利	myoori	fame and fortune
名状	meizyoo	description
名香	meikoo	fine incense
名答	meitoo	correct answer
名望	meiboo	reputation
名剣	meiken	famous sword
名菓	meika	excellent sweet
名流	meiryuu	celebrities
名宛	naate	address
名乗	nanori	giving one's name
名数	meisuu	number of people
名論	meiron	excellent opinion
名親	naoya	godparent
名題	nadai	chief actor
指名	simei	name
氏名	simei	full name
署名	syomei	signature
有名	yuumei	famous
本名	honmyoo	real name
匿名	tokumei	anonymity
著名	tyomei	well-known
実名	zitumei	real name
命名	meimei	naming
社名	syamei	name of company
無名	mumei	unsigned
仮名	kamei	alias
地名	timei	place name
除名	zyomei	expulsion
題名	daimei	title
同名	doomei	same name
異名	imyoo	another name
病名	byoomei	name of a disease
大名	daimyoo	daimyo
国名	kokumei	country name
連名	renmei	joint signature
改名	kaimei	name change
偽名	gimei	alias
汚名	omei	stigma
人名	zinmei	person's name
別名	betumei	alias
書名	syomei	book title
店名	tenmei	store name
功名	koomyoo	great achievement
党名	toomei	political party name
記名	kimei	signature
芸名	geimei	stage name
罪名	zaimei	name of a crime
高名	koomyoo	fame
悪名	akumei	bad reputation
駅名	ekimei	station name
学名	gakumei	technical name
姓名	seimei	full name
曲名	kyokumei	song title
和名	wamyoo	Japanese name
件名	kenmei	term
筆名	hitumei	alias
美名	bimei	good name
旧名	kyuumei	former name
売名	baimei	self-advertisement
品名	hinmei	name of product
家名	kamei	family name
職名	syokumei	official title
役名	yakumei	official title
幼名	yoomyoo	childhood name
宛名	atena	name
浮名	ukina	rumour
法名	hoomyoo	Buddhist name
知名	timei	well-known
英名	eimei	fame
御名	gyomei	name of the emperor
真名	mana	kanji
俗名	zokumyoo	common name
勇名	yuumei	fame
芳名	hoomei	good name
文名	bunmei	literary fame
渾名	adana	nickname
小名	syoomyoo	minor feudal lord
仇名	adana	nickname
変名	henmei	assumed name
下名	kamei	undermentioned
虚名	kyomei	false reputation
盛名	seimei	reputation
賊名	zokumei	"the name of ""rebel"""
武名	bumei	military fame
尊名	sonmei	your name
友人	yuuzin	friend
友達	tomodati	friend
友好	yuukoo	friendship
友情	yuuzyoo	friendship
友愛	yuuai	fraternity
友誼	yuugi	friendship
友軍	yuugun	friendly troops
友邦	yuuhoo	friendly nation
友釣	tomozuri	live decoy fishing
友垣	tomogaki	friend
親友	sinyuu	close friend
盟友	meiyuu	sworn friend
交友	kooyuu	friend
級友	kyuuyuu	classmate
戦友	senyuu	comrade in arms
旧友	kyuuyuu	crony
校友	kooyuu	schoolmate
学友	gakuyuu	school friend
朋友	hooyuu	friend
社友	syayuu	colleague
僚友	ryooyuu	colleague
悪友	akuyuu	undesirable friend
知友	tiyuu	friend
師友	siyuu	master and friends
益友	ekiyuu	good friend
良友	ryooyuu	good friend
来年	rainen	next year
来日	rainiti	arrival in Japan
来月	raigetu	next month
来季	raiki	next semester
来春	raisyun	next spring
来週	raisyuu	next week
来場	raizyoo	attendance
来夏	raika	next summer
来店	raiten	coming to the store
来訪	raihoo	visit
来客	raikyaku	visitor
来秋	raisyuu	next autumn
来賓	raihin	guest
来期	raiki	next term
来航	raikoo	arrival of ships
来襲	raisyuu	raid
来社	raisya	visit to a company
来歴	raireki	history
来世	raise	the next world
来校	raikoo	school visit
来援	raien	assistance
来演	raien	coming to perform
来遊	raiyuu	visit
来朝	raityoo	arriving in Japan
来会	raikai	attendance
来診	raisin	doctor's visit
来意	raii	purpose of a visit
来談	raidan	interview
来者	raisya	visitor
来臨	rairin	attendance
来観	raikan	inspection visit
来集	raisyuu	coming together
来書	raisyo	letter received
来聴	raityoo	attendance
以来	irai	since
将来	syoorai	future
従来	zyuurai	up to now
本来	honrai	originally
未来	mirai	the future
外来	gairai	foreign
由来	yurai	origin
出来	deki	workmanship
到来	toorai	arrival
往来	oorai	coming and going
在来	zairai	pre-existing
飛来	hirai	come flying
年来	nenrai	for some years
古来	korai	from time immemorial
旧来	kyuurai	traditional
再来	sairai	return
襲来	syuurai	invasion
伝来	denrai	ancestral
入来	nyuurai	august visit
渡来	torai	visit
生来	seirai	naturally
旧来	kyuurai	traditional
家来	kerai	retainer
去来	kyorai	coming and going
天来	tenrai	heavenly
朝来	tyoorai	ever since morning
舶来	hakurai	imported
年来	nenrai	for some years
招来	syoorai	invitation
如来	nyorai	Tathagata
近来	kinrai	recently
夜来	yarai	overnight
新来	sinrai	newcomer
帰来	kirai	returning
光来	koorai	your visit
行来	ikiki	coming and going
六月	rokugatu	June
六道	rokudoo	the six realms
六根	rokkon	six sense organs
六朝	rikutyoo	Six Dynasties
六法	roppoo	six law codes
六方	roppoo	the six directions
六部	rokubu	six copies
六合	rikugoo	the universe
双六	sugoroku	sugoroku
甚六	zinroku	dunce
宿六	yadoroku	husband
話題	wadai	topic
話術	wazyutu	art of conversation
話芸	wagei	storytelling
話法	wahoo	narration
話者	wasya	speaker
話柄	wahei	topic
電話	denwa	telephone call
対話	taiwa	dialogue
会話	kaiwa	conversation
談話	danwa	a talk
世話	sewa	looking after
通話	tuuwa	telephone call
神話	sinwa	myth
童話	doowa	fairy-tale
手話	syuwa	sign language
逸話	ituwa	anecdote
昔話	mukasibanasi	folklore
懇話	konwa	chat
実話	zituwa	true story
秘話	hiwa	secret story
民話	minwa	folklore
寓話	guuwa	fable
裏話	urabanasi	inside story
講話	koowa	lecture
説話	setuwa	tale
挿話	soowa	episode
法話	hoowa	Buddhist sermon
小話	kobanasi	anecdote
夜話	yawa	night chat
茶話	tyawa	a chat over tea
長話	nagabanasi	long talk
訓話	kunwa	exemplum
発話	hatuwa	utterance
悲話	hiwa	sad or tragic story
謹話	kinwa	respectful comments
笑話	syoowa	amusing story
哀話	aiwa	sad story
佳話	kawa	good story
閑話	kanwa	quiet conversation
白話	hakuwa	colloquial Chinese
雑話	zatuwa	chitchat
受話	zyuwa	reception
送話	soowa	transmission
官話	kanwa	Mandarin
痴話	tiwa	lovers talk
直話	zikiwa	one's own account