Japanese	English
あいさつ	greeting
あいだ	between
あう	 fit
あう	to meet
あおい	blue
あかい	red
あかちゃん	baby
あがる	to go up
あかるい	light
あかんぼう	baby
あき	autumn
あく	open
あく	empty
あける	to open
あげる	to rise
あさ	morning
あさごはん	breakfast
あさねぼう	a late riser
あし	leg
あじ	taste
あした	tomorrow
あす	tomorrow (polite)
あそぶ	to play
あたたかい	warm
あたま	head
あたらしい	new
あつい	hot (air)
あつい	thick
あと	later
あなた	you
あに	older brother
あね	older sister
あびる	to take a shower
あぶない	dangerous
あまい	sweet
あめ	rain
あらう	to wash
ある	to be
ありく	to walk
いい/よい	good
いう	to say
いえ	house
いく	to go
いけ	pond
いしゃ	doctor
いす	chair
いそがしい	to be busy
いたい	to be painful
いち	one
いちにち	one day
いっしょ	together
いつつ	five
いま	now
いみ	meaning
いりぐち	entrance
いろ	color
いろいろ	various
うえ	top
うしろ	back
うすい	thin
うた	song
うたう	to sing
うち	home
うまれる	to be born
うみ	sea
うる	to sell
うわぎ	coat
え	picture
えいが	movie
えいがかん	cinema
英語	English language
えき	station
えん	Yen
えんぴつ	pencil
お	honorific prefix
おいしい	tasty
おおきい	big
おかあさん	my own mother
okashi	confectionary
おかね	money
おくさん	someone’s wife
おくる	to send
おさけ	alcohol
おさら	plate
おじさん	uncle
おす	to push
おそい	late
おちゃ	tea
おてあらい	toilet
おとうさん	father
おとこ	man
おとこのこ	boy
おとな	adult
おなか	stomach
おなじ	same
おばさん	aunt
おべんとう	lunchbox
おもい	heavy
おもしろい	interesting
およぐ	to swim
おりる	to get off
おわる	to end
おんがく	music
おんな	woman
おんなのこ	girl
〜かい	~times
〜かい	~floor
がいこく	foreign country
がいこくじん	foreigner
かいしゃ	company
かいだん	stairs
かいもの	shopping
かう	to buy
かえす	to return an object
かえる	to return home
かお	face
かぎ	key
かく	to write
がくせい	student
〜かげつ	~ number of months
かさ	umbrella
かす	to lend
かぜ	wind
かぜ	a cold
かぞく	family
かた	person (polite)
かたかな	Katakana
いちがつ	January
にがつ	February
さんがつ	March
しがつ	April
ごがつ	May
ろくがつ	June
しちがつ	July
はちがつ	August
くがつ	September
じゅうがつ	October
じゅういちがつ	November
じゅうにがつ	December
がっこう	school
かど	corner
かない	my wife
かばん	bag
かびん	vase
かぶる	to put on a hat
かみ	paper
かようび	Tuesday
からい	hot
からだ	body
かりる	to borrow
かるい	light (not heavy)
かわ	river
~がわ	~side
かわいい	cute
かんじ	Kanji character
き	 Spirit
きかい	Opportunity
きけん	Danger
きこえる	to be heard
きしゃ	steam train
きせつ	season
きそく	regulations
きぬ	Silk
きびしい	strict
きぶん	mood
きまる	to be decided
きみ	You (informal)
きめる	to decide
きもち	feeling
きもの	a kimono
きゃく	guest
きゅう	urgent
きゅうこう	speedy
きょういく	education
きょうかい	church
きょうそう	competition
きょうみ	an interest
きんじょ	neighbourhood
ぐあい	condition
くうき	air
くうこう	airport
くさ	grass
くび	neck
くも	cloud
くらべる	to compare
け	hair or fur
けいかく	plan
けいけん	experience
けいざい	finance
けいさつ	police
けが	an injury
けしき	landscape
けしごむ	an eraser
げしゅく	lodging
けっして	never
げんいん	source
けんか	a quarrel
けんきゅう	research
けんきゅうしつ	laboratory
けんぶつ	sightseeing
こ	child
こうがい	outskirts
こうぎ	lecture
こうこう	high school
こうじょう	factory
こうちょう	headmaster
こうどう	auditorium
こうむいん	Government worker
こくさい	international
こころ	core
こたえ	response
ことり	small
こまかい	smal
こむ	to be crowded
こめ	uncooked rice
ごらんになる	to see(respectful)
こわい	frightening
こわす	to break
こわれる	to be broken
こんど	now
こんや	tonight
さいきん	nowadays
さいご	last
さいしょ	beginning
さか	slope
さがす	to look for
さがる	to get down
さかん	popular
さげる	to lower
さびしい	lonely
さらいしゅう	the week after next
さわる	to touch
さんぎょう	industry
ざんねん	disappointment
し	city
じ	city
しあい	match
しかた	method
しかる	to scold
しけん	exam
じこ	accident
じしん	earthquake
じだい	era
したぎ	underwear
したく	preparations
しっぱい	failure
じてん	dictionary
しなもの	goods
しま	island
しみん	citizen
じむしょ	office
しゃかい	society
しゃちょう	company president
じゆう	freedom
しゅうかん	custom
じゅうどう	judo
じゅうぶん	enough
しゅっせき	attendance
しゅっぱつ	departure
しゅみ	a hobby
じゅんび	preparation
しょうかい	introduction
しょうがっこう	elementary school
しょうせつ	novel
しょうたい	invitation
しょうち	consentment
しょうらい	future
しょくじ	a meal
しょくりょうひん	groceries
じょせい	woman
しらせる	to notify
しらべる	to investigate
じんこう	population
じんじゃ	Shinto shrine
しんせつ	kindness
しんぱい	worries
しんぶんしゃ	newspaper company
すいえい	swimming
すいどう	water supply
すぎる	to exceed
すく	to become empty
すごい	terrific
すすむ	to make progress
すてる	to throw away
すな	sand
すばらしい	wonderful
すべる	to slide
すみ	corner
すむ	to finish
せいかつ	life
せいさん	production
せいよう	western countries
せかい	the world
せき	seat
せつめい	explanation
ぜひ	without fail
せわ	to look after
せん	line
せんそう	war
せんぱい	senior
そうだん	to discuss
そつぎょう	graduation
そふ	grandfather
そぼ	grandmother
たいいん	leave hospital
だいがくせい	university student
だいじ	important
だいたい	generally
だいぶ	greatly
たいふう	typhoon
たおれる	to break down
たしか	definite
たす	to add a number
たずねる	 to visit
たずねる	 to ask
ただしい	correct
たたみ	a Tatami
たてる	stand up
たてる	to build
たとえば	for example
たな	shelves
たのしみ	pleasure
ため	in order to
だめ	no good
たりる	be sufficient
だんせい	man
だんぼう	heating
ち	blood
ちから	strengh
ちゅうい	caution
ちゅうがっこう	junior high school
ちゅうしゃ	injection
ちゅうしゃじょう	parking lot
ちり	geography
つかまえる	to seize
つき	moon
つく	to be attached
つける	to soak
つごう	circumstances
つたえる	to report
つづく	continue
つづける	to continue
つつむ	to wrap
つま	wife
つる	to fish
つれる	to lead
ていねい	polite
てきとう	suitable
てつだう	to assist
てぶくろ	glove
てら	temple
てん	point
てんいん	shop assistant
てんきよほう	weather forecast
でんとう	electric light
でんぽう	 telegram
てんらんかい	exhibition
と	metropolitan
どうぐ	tool
どうぶつえん	zoo
とおく	distant
とおる	to go through
とくべつ	special
とこや	a barber shop
とちゅう	on the way
とどける	to reach
とまる	to lodge at
とめる	to stop
とりかえる	to exchange
どろぼう	thief
なおす	to fix
なかなか	considerably
なく	to cry
なくなる	to die
なげる	to throw away
なる	sound
におい	a smell
にがい	bitter
にかいだて	two storied
にげる	to escape
にっき	diary
にゅういん	be hospitalized
にる	to be similar
にんぎょう	a doll
ぬすむ	to steal
ぬる	to paint
ぬれる	to get wet
ねだん	price
ねつ	fever
ねっしん	enthusiasm
ねぼう	sleeping in late
ねむい	to be sleepy
ねむる	to sleep
のこる	to remain
のりかえる	to tansfer
のりもの	vehicle
は	leaf
ばあい	situation
ばい	twice
はいしゃ	dentist
はこぶ	to transport
はじめる	to begin
ばしょ	location
はずかしい	embarrassed
はつおん	pronunciation
はやし	woods
はらう	to pay
はんたい	Opposition
ひ	day
ひ	fire
ひかり	light
ひかる	to shine
ひきだし	drawer
ひきだす	to draw out
ひげ	a mustache
ひこうじょう	an airport
ひさしぶり	after a long time
びじゅつかん	art gallery
ひじょうに	extremely
びっくり	be surprised
ひっこす	to move (house)
ひつよう	necessary
ひどい	awful
ひらく	to open an event
ひるやすみ	noon break
ふえる	to increase
ふかい	deep
ふくしゅう	revision
ぶちょう	head of a section
ふつう	usually
ぶどう	a grape
ふとる	to grow fat
ふとん	Japanese bed
ふね	ship
ふべん	inconvenience
ふむ	to step on
ふりだす	start to rain
ぶんか	culture
ぶんがく	litterature
ぶんぽう	grammar
べつ	different
へん	strange
へんじ	reply
ぼうえき	trade
ほうそう	to broadcast
ほうりつ	law
ぼく	I (for male)
ほし	star
ほんやく	translation
まける	to lose
まじめ	serious
まちがえる	to make a mistake
まにあう	to be in time for
まわり	surroundings
まわる	to go around
まんなか	middle
みえる	be seen
みずうみ	a lake
みそ	bean paste
みつかる	to be discovered
みつける	to discover
みな	everybody
みなと	harbour
むかう	to face
むかえる	to go to meet
むかし	olden days
むし	insect
むすこ	son
むすめ	daughter
むり	impossible
めしあがる	to eat (respectful)
めずらしい	rare
もめん	cotton
もらう	to receive
もり	forest
やく	to bake
やくそく	promise
やくにたつ	to be helpful
やさしい	kind
やせる	to become thin
やむ	to stop
やめる	to stop
やわらかい	soft
ゆ	hot water
ゆしゅつ	export
ゆにゅう	import
ゆび	finger
ゆびわ	a ring
ゆめ	dream
ゆれる	to shake
よう	use
ようい	preparation
ようじ	things to do
よごれる	to get dirty
よてい	arrangement
よやく	reservation
よる	to visit
よろこぶ	to be delighted
りゆう	reason
りよう	utilization
りょうほう	both sides
るす	absence
れいぼう	air conditioning
れきし	history
れんらく	contact
わかす	to boil
わかれる	to separate
わけ	meaning
わすれもの	lost article
わらう	to laugh
われる	to break