Kanji	Furigana	Romaji	Meaning
挨拶	あいさつ	aisatsu	greeting
間	あいだ	aida	between
合う	あう	au	 fit
会う	あう	au	to meet
青い	あおい	aoi	blue
赤い	あかい	akai	red
赤ちゃん	あかちゃん	akachan	baby
上がる	あがる	agaru	to go up
明るい	あかるい	akarui	light
赤ん坊	あかんぼう	akanbou	baby
秋	あき	aki	autumn
開く	あく	aku	open
空く	あく	aku	empty
開ける	あける	akeru	to open
上げる	あげる	ageru	to rise
朝	あさ	asa	morning
朝ご飯	あさごはん	asagohan	breakfast
朝寝坊	あさねぼう	asanebou	a late riser
足	あし	ashi	leg
味	あじ	aji	taste
明日	あした	ashita	tomorrow
明日	あす	asu	tomorrow (polite)
遊ぶ	あそぶ	asobu	to play
温かい	あたたかい	atatakai	warm
頭	あたま	atama	head
新しい	あたらしい	atarashii	new
暑い	あつい	atsui	hot (air)
厚い	あつい	atsui	thick
後	あと	ato	later
貴方	あなた	anata	you
兄	あに	ani	older brother
姉	あね	ane	older sister
浴びる	あびる	abiru	to take a shower
危ない	あぶない	abunai	dangerous
甘い	あまい	amai	sweet
雨	あめ	ame	rain
洗う	あらう	arau	to wash
有る	ある	aru	to be
歩く	ありく	aruku	to walk
良い	いい/よい	ii,yoi	good
言う	いう	iu	to say
家	いえ	ie	house
行く	いく	iku	to go
池	いけ	ike	pond
医者	いしゃ	isha	doctor
椅子	いす	isu	chair
忙しい	いそがしい	isogashii	to be busy
痛い	いたい	itai	to be painful
一	いち	ichi	one
一日	いちにち	ichinichi	one day
一緒	いっしょ	issho	together
五つ	いつつ	itsutsu	five
今	いま	ima	now
意味	いみ	imi	meaning
入口	いりぐち	iriguchi	entrance
色	いろ	iro	color
色々	いろいろ	iroiro	various
上	うえ	ue	top
後ろ	うしろ	ushiro	back
薄い	うすい	usui	thin
歌	うた	uta	song
歌う	うたう	utau	to sing
内	うち	uchi	home
生まれる	うまれる	umareru	to be born
海	うみ	umi	sea
売る	うる	uru	to sell
上着	うわぎ	uwagi	coat
絵	え	e	picture
映画	えいが	eiga	movie
映画館	えいがかん	eigakan	cinema
英語	英語	eigo	English language
駅	えき	eki	station
円	えん	en	Yen
鉛筆	えんぴつ	enpitsu	pencil
御	お	o	honorific prefix
美味しい	おいしい	oishii	tasty
大きい	おおきい	ookii	big
お母さん	おかあさん	okaasan	my own mother
お菓子	okashi	okashi	confectionary
お金	おかね	okane	money
奥さん	おくさん	okusan	someone’s wife
送る	おくる	okuru	to send
お酒	おさけ	osake	alcohol
お皿	おさら	osara	plate
伯父さん	おじさん	ojisan	uncle
押す	おす	osu	to push
遅い	おそい	osoi	late
お茶	おちゃ	ocha	tea
お手洗い	おてあらい	otearai	toilet
お父さん	おとうさん	otousan	father
男	おとこ	otoko	man
男の子	おとこのこ	otokonoko	boy
大人	おとな	otona	adult
お腹	おなか	onaka	stomach
同じ	おなじ	onaji	same
伯母さん	おばさん	obasan	aunt
お弁当	おべんとう	obentou	lunchbox
重い	おもい	omoi	heavy
面白い	おもしろい	omoshiroi	interesting
泳ぐ	およぐ	oyogu	to swim
降りる	おりる	oriru	to get off
終わる	おわる	owaru	to end
音楽	おんがく	ongaku	music
女	おんな	onna	woman
女の子	おんなのこ	onnanoko	girl
〜回	〜かい	~kai	~times
〜階	〜かい	~kai	~floor
外国	がいこく	gaikoku	foreign country
外国人	がいこくじん	gaikokujin	foreigner
会社	かいしゃ	kaisha	company
階段	かいだん	kaidan	stairs
買物	かいもの	kaimono	shopping
買う	かう	kau	to buy
返す	かえす	kaesu	to return an object
帰る	かえる	kaeru	to return home
顔	かお	kao	face
鍵	かぎ	kagi	key
書く	かく	kaku	to write
学生	がくせい	gakusei	student
〜か月	〜かげつ	~kagetsu	~ number of months
傘	かさ	kasa	umbrella
貸す	かす	kasu	to lend
風	かぜ	kaze	wind
風邪	かぜ	kaze	a cold
家族	かぞく	kazoku	family
方	かた	kata	person (polite)
片仮名	かたかな	katakana	Katakana
一月	いちがつ	ichigatsu	January
二月	にがつ	nigatsu	February
三月	さんがつ	sangatsu	March
四月	しがつ	shigatsu	April
五月	ごがつ	gogatsu	May
六月	ろくがつ	rokugatsu	June
七月	しちがつ	shichigatsu	July
八月	はちがつ	hachigatsu	August
九月	くがつ	kugatsu	September
十月	じゅうがつ	juugatsu	October
十一月	じゅういちがつ	juuichigatsu	November
十二月	じゅうにがつ	juunigatsu	December
学校	がっこう	gakkou	school
角	かど	kado	corner
家内	かない	kanai	my wife
鞄	かばん	kaban	bag
花瓶	かびん	kabin	vase
冠る	かぶる	kaburu	to put on a hat
紙	かみ	kami	paper
火曜日	かようび	kayoubi	Tuesday
辛い	からい	karai	hot
体	からだ	karada	body
借りる	かりる	kariru	to borrow
軽い	かるい	karui	light (not heavy)
川	かわ	kawa	river
〜側	~がわ	~gawa	~side
可愛い	かわいい	kawaii	cute
漢字	かんじ	kanji	Kanji character
気	き	ki	 Spirit
機会	きかい	kikai	Opportunity
危険	きけん	Kiken	Danger
聞こえる	きこえる	kikoeru	to be heard
汽車	きしゃ	kisha	steam train
季節	きせつ	kisetsu	season
規則	きそく	kisoku	regulations
絹	きぬ	kinu	Silk
厳しい	きびしい	kibishii	strict
気分	きぶん	kibun	mood
決まる	きまる	kimaru	to be decided
君	きみ	kimi	You (informal)
決める	きめる	kimeru	to decide
気持ち	きもち	kimochi	feeling
着物	きもの	kimono	a kimono
客	きゃく	kyaku	guest
急	きゅう	kyuu	urgent
急行	きゅうこう	kyuukou	speedy
教育	きょういく	kyouiku	education
教会	きょうかい	kyoukai	church
競争	きょうそう	kyousou	competition
興味	きょうみ	kyoumi	an interest
近所	きんじょ	kinjo	neighbourhood
具合	ぐあい	guai	condition
空気	くうき	kuuki	air
空港	くうこう	kuukou	airport
草	くさ	kusa	grass
首	くび	kubi	neck
雲	くも	kumo	cloud
比べる	くらべる	kuraberu	to compare
毛	け	ke	hair or fur
計画	けいかく	keikaku	plan
経験	けいけん	keiken	experience
経済	けいざい	keizai	finance
警察	けいさつ	keisatsu	police
怪我	けが	kega	an injury
景色	けしき	keshiki	landscape
消しゴム	けしごむ	keshigomu	an eraser
下宿	げしゅく	geshuku	lodging
決して	けっして	kesshite	never
原因	げんいん	genin	source
喧嘩	けんか	kenka	a quarrel
研究	けんきゅう	kenkyuu	research
研究室	けんきゅうしつ	kenkyuushitsu	laboratory
見物	けんぶつ	kenbutsu	sightseeing
子	こ	ko	child
郊外	こうがい	kougai	outskirts
講義	こうぎ	kougi	lecture
高校	こうこう	koukou	high school
工場	こうじょう	koujyou	factory
校長	こうちょう	kouchou	headmaster
講堂	こうどう	koudou	auditorium
公務員	こうむいん	koumuin	Government worker
国際	こくさい	kokusai	international
心	こころ	kokoro	core
答	こたえ	kotae	response
小鳥	ことり	kotori	small
細かい	こまかい	komakai	smal
込む	こむ	komu	to be crowded
米	こめ	kome	uncooked rice
ご覧になる	ごらんになる	goranninaru	to see(respectful)
怖い	こわい	kowai	frightening
壊す	こわす	kowasu	to break
壊れる	こわれる	kowareru	to be broken
今度	こんど	kondo	now
今夜	こんや	konya	tonight
最近	さいきん	Saikin	nowadays
最後	さいご	saigo	last
最初	さいしょ	saisho	beginning
坂	さか	saka	slope
探す	さがす	sagasu	to look for
下がる	さがる	sagaru	to get down
盛ん	さかん	sakan	popular
下げる	さげる	sageru	to lower
寂しい	さびしい	sabishii	lonely
再来週	さらいしゅう	saraishuu	the week after next
触る	さわる	sawaru	to touch
産業	さんぎょう	sangyou	industry
残念	ざんねん	zannen	disappointment
市	し	shi	city
字	じ	ji	city
試合	しあい	shiai	match
仕方	しかた	shikata	method
叱る	しかる	shikaru	to scold
試験	しけん	shiken	exam
事故	じこ	jiko	accident
地震	じしん	jishin	earthquake
時代	じだい	jidai	era
下着	したぎ	shitagi	underwear
支度	したく	shitaku	preparations
失敗	しっぱい	shippai	failure
辞典	じてん	jiten	dictionary
品物	しなもの	shinamono	goods
島	しま	shima	island
市民	しみん	shimin	citizen
事務所	じむしょ	jimusho	office
社会	しゃかい	shakai	society
社長	しゃちょう	shachou	company president
自由	じゆう	jiyuu	freedom
習慣	しゅうかん	shuukan	custom
柔道	じゅうどう	jyuudou	judo
十分	じゅうぶん	jyuubun	enough
出席	しゅっせき	shusseki	attendance
出発	しゅっぱつ	shuppatsu	departure
趣味	しゅみ	shumi	a hobby
準備	じゅんび	junbi	preparation
紹介	しょうかい	shoukai	introduction
小学校	しょうがっこう	shougakkou	elementary school
小説	しょうせつ	shousetsu	novel
招待	しょうたい	shoutai	invitation
承知	しょうち	shouchi	consentment
将来	しょうらい	shourai	future
食事	しょくじ	shokuji	a meal
食料品	しょくりょうひん	shokuryouhin	groceries
女性	じょせい	jyosei	woman
知らせる	しらせる	shiraseru	to notify
調べる	しらべる	shiraberu	to investigate
人口	じんこう	jinkou	population
神社	じんじゃ	jinja	Shinto shrine
親切	しんせつ	shinsetsu	kindness
心配	しんぱい	shinpai	worries
新聞社	しんぶんしゃ	shinbunnsha	newspaper company
水泳	すいえい	suiei	swimming
水道	すいどう	suidou	water supply
過ぎる	すぎる	sugiru	to exceed
空く	すく	suku	to become empty
凄い	すごい	sugoi	terrific
進む	すすむ	susumu	to make progress
捨てる	すてる	suteru	to throw away
砂	すな	suna	sand
素晴らしい	すばらしい	subarashii	wonderful
滑る	すべる	suberu	to slide
隅	すみ	sumi	corner
済む	すむ	sumu	to finish
生活	せいかつ	seikatsu	life
生産	せいさん	seisan	production
西洋	せいよう	seiyou	western countries
世界	せかい	sekai	the world
席	せき	seki	seat
説明	せつめい	setsumei	explanation
是非	ぜひ	zehi	without fail
世話	せわ	sewa	to look after
線	せん	sen	line
戦争	せんそう	sensou	war
先輩	せんぱい	senpai	senior
相談	そうだん	soudan	to discuss
卒業	そつぎょう	sotsugyou	graduation
祖父	そふ	sofu	grandfather
祖母	そぼ	sobo	grandmother
退院	たいいん	taiin	leave hospital
大学生	だいがくせい	daigakusei	university student
大事	だいじ	daiji	important
大体	だいたい	daitai	generally
大分	だいぶ	daibu	greatly
台風	たいふう	taifuu	typhoon
倒れる	たおれる	taoreru	to break down
確か	たしか	tashika	definite
足す	たす	tasu	to add a number
訪ねる	たずねる	tazuneru	 to visit
尋ねる	たずねる	tazuneru	 to ask
正しい	ただしい	tadashii	correct
畳	たたみ	tatami	a Tatami
立てる	たてる	tateru	stand up
建てる	たてる	tateru	to build
例えば	たとえば	tatoeba	for example
棚	たな	tana	shelves
楽しみ	たのしみ	tanoshimi	pleasure
為	ため	tame	in order to
駄目	だめ	dame	no good
足りる	たりる	tariru	be sufficient
男性	だんせい	dansei	man
暖房	だんぼう	danbou	heating
血	ち	chi	blood
力	ちから	chikara	strengh
注意	ちゅうい	chuui	caution
中学校	ちゅうがっこう	chuugakkou	junior high school
注射	ちゅうしゃ	chuusha	injection
駐車場	ちゅうしゃじょう	chuushajou	parking lot
地理	ちり	chiri	geography
捕まえる	つかまえる	tsukamaeru	to seize
月	つき	tsuki	moon
付く	つく	tsuku	to be attached
漬ける	つける	tsukeru	to soak
都合	つごう	tsugou	circumstances
伝える	つたえる	tsutaeru	to report
続く	つづく	tsuzuku	continue
続ける	つづける	tsuzukeru	to continue
包む	つつむ	tsutsumu	to wrap
妻	つま	tsuma	wife
釣る	つる	tsuru	to fish
連れる	つれる	tsureru	to lead
丁寧	ていねい	teinei	polite
適当	てきとう	tekitou	suitable
手伝う	てつだう	tetsudau	to assist
手袋	てぶくろ	tebukuro	glove
寺	てら	tera	temple
点	てん	ten	point
店員	てんいん	tenin	shop assistant
天気予報	てんきよほう	tenkiyohou	weather forecast
電灯	でんとう	dentou	electric light
電報	でんぽう	denpou	 telegram
展覧会	てんらんかい	tenrankai	exhibition
都	と	to	metropolitan
道具	どうぐ	dougu	tool
動物園	どうぶつえん	doubutsuen	zoo
遠く	とおく	tooku	distant
通る	とおる	tooru	to go through
特別	とくべつ	tokubetsu	special
床屋	とこや	tokoya	a barber shop
途中	とちゅう	tochuu	on the way
届ける	とどける	todokeru	to reach
泊まる	とまる	tomaru	to lodge at
止める	とめる	tomeru	to stop
取り替える	とりかえる	torikaeru	to exchange
泥棒	どろぼう	dorobou	thief
直す	なおす	naosu	to fix
中々	なかなか	nakanaka	considerably
泣く	なく	naku	to cry
亡くなる	なくなる	nakunaru	to die
投げる	なげる	nageru	to throw away
鳴る	なる	naru	sound
匂い	におい	nioi	a smell
苦い	にがい	nigai	bitter
二階建て	にかいだて	nikaidate	two storied
逃げる	にげる	nigeru	to escape
日記	にっき	nikki	diary
入院	にゅういん	nyuuin	be hospitalized
似る	にる	niru	to be similar
人形	にんぎょう	ninngyou	a doll
盗む	ぬすむ	nusumu	to steal
塗る	ぬる	nuru	to paint
濡れる	ぬれる	nureru	to get wet
値段	ねだん	nedan	price
熱	ねつ	netsu	fever
熱心	ねっしん	nesshin	enthusiasm
寝坊	ねぼう	nebou	sleeping in late
眠い	ねむい	nemui	to be sleepy
眠る	ねむる	nemuru	to sleep
残る	のこる	nokoru	to remain
乗り換える	のりかえる	norikaeru	to tansfer
乗り物	のりもの	norimono	vehicle
葉	は	ha	leaf
場合	ばあい	baai	situation
倍	ばい	bai	twice
歯医者	はいしゃ	haisha	dentist
運ぶ	はこぶ	hakobu	to transport
始める	はじめる	hajimeru	to begin
場所	ばしょ	basho	location
恥ずかしい	はずかしい	hazukashii	embarrassed
発音	はつおん	hatsuon	pronunciation
林	はやし	hayashi	woods
払う	はらう	harau	to pay
反対	はんたい	hantai	Opposition
日	ひ	hi	day
火	ひ	hi	fire
光	ひかり	hikari	light
光る	ひかる	hikaru	to shine
引き出し	ひきだし	hikidashi	drawer
引き出す	ひきだす	hikidasu	to draw out
髭	ひげ	hige	a mustache
飛行場	ひこうじょう	hikoujou	an airport
久しぶり	ひさしぶり	hisashiburi	after a long time
美術館	びじゅつかん	bijyutsukan	art gallery
非常に	ひじょうに	hijouni	extremely
吃驚	びっくり	bikkuri	be surprised
引っ越す	ひっこす	hikkosu	to move (house)
必要	ひつよう	hitsuyou	necessary
酷い	ひどい	hidoi	awful
開く	ひらく	hiraku	to open an event
昼休み	ひるやすみ	hiruyasumi	noon break
増える	ふえる	fueru	to increase
深い	ふかい	fukai	deep
復習	ふくしゅう	fukushuu	revision
部長	ぶちょう	buchou	head of a section
普通	ふつう	futsuu	usually
葡萄	ぶどう	budou	a grape
太る	ふとる	futoru	to grow fat
布団	ふとん	futon	Japanese bed
船	ふね	fune	ship
不便	ふべん	fuben	inconvenience
踏む	ふむ	fumu	to step on
降り出す	ふりだす	furidasu	start to rain
文化	ぶんか	bunka	culture
文学	ぶんがく	bungaku	litterature
文法	ぶんぽう	bunpou	grammar
別	べつ	betsu	different
変	へん	hen	strange
返事	へんじ	henji	reply
貿易	ぼうえき	boueki	trade
放送	ほうそう	housou	to broadcast
法律	ほうりつ	houritsu	law
僕	ぼく	boku	I (for male)
星	ほし	hoshi	star
翻訳	ほんやく	honyaku	translation
負ける	まける	makeru	to lose
真面目	まじめ	majime	serious
間違える	まちがえる	machigaeru	to make a mistake
間に合う	まにあう	maniau	to be in time for
周り	まわり	mawari	surroundings
回る	まわる	mawaru	to go around
真ん中	まんなか	mannaka	middle
見える	みえる	mieru	be seen
湖	みずうみ	mizuumi	a lake
味噌	みそ	miso	bean paste
見つかる	みつかる	mitsukaru	to be discovered
見つける	みつける	mitsukeru	to discover
皆	みな	mina	everybody
港	みなと	minato	harbour
向かう	むかう	mukau	to face
迎える	むかえる	mukaeru	to go to meet
昔	むかし	mukashi	olden days
虫	むし	mushi	insect
息子	むすこ	musuko	son
娘	むすめ	musume	daughter
無理	むり	muri	impossible
召し上がる	めしあがる	meshiagaru	to eat (respectful)
珍しい	めずらしい	mezurashii	rare
木綿	もめん	momen	cotton
貰う	もらう	morau	to receive
森	もり	mori	forest
焼く	やく	yaku	to bake
約束	やくそく	yakusoku	promise
役に立つ	やくにたつ	yakunitatsu	to be helpful
優しい	やさしい	yasashii	kind
痩せる	やせる	yaseru	to become thin
止む	やむ	yamu	to stop
止める	やめる	yameru	to stop
柔らかい	やわらかい	yawarakai	soft
湯	ゆ	yu	hot water
輸出	ゆしゅつ	yushutsu	export
輸入	ゆにゅう	yunyuu	import
指	ゆび	yubi	finger
指輪	ゆびわ	yubiwa	a ring
夢	ゆめ	yume	dream
揺れる	ゆれる	yureru	to shake
用	よう	you	use
用意	ようい	youi	preparation
用事	ようじ	youji	things to do
汚れる	よごれる	yogoreru	to get dirty
予定	よてい	yotei	arrangement
予約	よやく	yoyaku	reservation
寄る	よる	yoru	to visit
喜ぶ	よろこぶ	yorokobu	to be delighted
理由	りゆう	riyuu	reason
利用	りよう	riyou	utilization
両方	りょうほう	ryouhou	both sides
留守	るす	rusu	absence
冷房	れいぼう	reibou	air conditioning
歴史	れきし	rekishi	history
連絡	れんらく	renraku	contact
沸かす	わかす	wakasu	to boil
別れる	わかれる	wakareru	to separate
訳	わけ	wake	meaning
忘れ物	わすれもの	wasuremono	lost article
笑う	わらう	warau	to laugh
割れる	われる	wareru	to break